*********** # 1 **************
PokerStars Hand #257045862415: Tournament #3910307458, $0.98+$0.12 USD Hold'em No Limit - Level V (40/80) - 2025/07/22 10:10:49 ET
Table '3910307458 12' 9-max Seat #3 is the button
Seat 1: jojosetubal (7835 in chips)
Seat 2: Kaptahh (8377 in chips)
Seat 3: Andrew Willian (1789 in chips)
Seat 4: Maks19111979 (2900 in chips)
Seat 5: SuKKinho (4058 in chips)
Seat 6: petretudor (636 in chips)
Seat 7: varen1k322 (2804 in chips)
Seat 8: Cyan Diogenes (9040 in chips)
Seat 9: phpro (3000 in chips)
jojosetubal: posts the ante 10
Kaptahh: posts the ante 10
Andrew Willian: posts the ante 10
Maks19111979: posts the ante 10
SuKKinho: posts the ante 10
petretudor: posts the ante 10
varen1k322: posts the ante 10
Cyan Diogenes: posts the ante 10
phpro: posts the ante 10
Maks19111979: posts small blind 40
SuKKinho: posts big blind 80
*** HOLE CARDS ***
Dealt to phpro [9d Qc]
petretudor: raises 546 to 626 and is all-in
varen1k322: folds
Cyan Diogenes: folds
phpro: folds
jojosetubal: folds
Kaptahh: folds
Andrew Willian: folds
Maks19111979: folds
SuKKinho: folds
Uncalled bet (546) returned to petretudor
petretudor collected 290 from pot
petretudor: doesn't show hand
*** SUMMARY ***
Total pot 290 | Rake 0
Seat 1: jojosetubal folded before Flop (didn't bet)
Seat 2: Kaptahh folded before Flop (didn't bet)
Seat 3: Andrew Willian (button) folded before Flop (didn't bet)
Seat 4: Maks19111979 (small blind) folded before Flop
Seat 5: SuKKinho (big blind) folded before Flop
Seat 6: petretudor collected (290)
Seat 7: varen1k322 folded before Flop (didn't bet)
Seat 8: Cyan Diogenes folded before Flop (didn't bet)
Seat 9: phpro folded before Flop (didn't bet)


*********** # 2 **************
PokerStars Hand #257045867083: Tournament #3910307458, $0.98+$0.12 USD Hold'em No Limit - Level V (40/80) - 2025/07/22 10:11:21 ET
Table '3910307458 12' 9-max Seat #4 is the button
Seat 1: jojosetubal (7825 in chips)
Seat 2: Kaptahh (8367 in chips)
Seat 3: Andrew Willian (1779 in chips)
Seat 4: Maks19111979 (2850 in chips)
Seat 5: SuKKinho (3968 in chips)
Seat 7: varen1k322 (2794 in chips)
Seat 8: Cyan Diogenes (9030 in chips)
Seat 9: phpro (2990 in chips)
jojosetubal: posts the ante 10
Kaptahh: posts the ante 10
Andrew Willian: posts the ante 10
Maks19111979: posts the ante 10
SuKKinho: posts the ante 10
varen1k322: posts the ante 10
Cyan Diogenes: posts the ante 10
phpro: posts the ante 10
SuKKinho: posts small blind 40
varen1k322: posts big blind 80
*** HOLE CARDS ***
Dealt to phpro [9d 7c]
Cyan Diogenes: folds
phpro: folds
jojosetubal: folds
Kaptahh: folds
Andrew Willian: folds
Maks19111979: raises 80 to 160
SuKKinho: folds
varen1k322: calls 80
*** FLOP *** [Ts 2c 9c]
varen1k322: checks
martelli1990 is disconnected
Maks19111979: checks
*** TURN *** [Ts 2c 9c] [Jc]
varen1k322: bets 225
Maks19111979: folds
Uncalled bet (225) returned to varen1k322
varen1k322 collected 440 from pot
*** SUMMARY ***
Total pot 440 | Rake 0
Board [Ts 2c 9c Jc]
Seat 1: jojosetubal folded before Flop (didn't bet)
Seat 2: Kaptahh folded before Flop (didn't bet)
Seat 3: Andrew Willian folded before Flop (didn't bet)
Seat 4: Maks19111979 (button) folded on the Turn
Seat 5: SuKKinho (small blind) folded before Flop
Seat 7: varen1k322 (big blind) collected (440)
Seat 8: Cyan Diogenes folded before Flop (didn't bet)
Seat 9: phpro folded before Flop (didn't bet)


*********** # 3 **************
PokerStars Hand #257045873643: Tournament #3910307458, $0.98+$0.12 USD Hold'em No Limit - Level VI (50/100) - 2025/07/22 10:12:06 ET
Table '3910307458 12' 9-max Seat #5 is the button
Seat 1: jojosetubal (7815 in chips)
Seat 2: Kaptahh (8357 in chips)
Seat 3: Andrew Willian (1769 in chips)
Seat 4: Maks19111979 (2680 in chips)
Seat 5: SuKKinho (3918 in chips)
Seat 6: martelli1990 (3000 in chips) out of hand (moved from another table into small blind)
Seat 7: varen1k322 (3064 in chips)
Seat 8: Cyan Diogenes (9020 in chips)
Seat 9: phpro (2980 in chips)
martelli1990 will be allowed to play after the button
jojosetubal: posts the ante 12
Kaptahh: posts the ante 12
Andrew Willian: posts the ante 12
Maks19111979: posts the ante 12
SuKKinho: posts the ante 12
varen1k322: posts the ante 12
Cyan Diogenes: posts the ante 12
phpro: posts the ante 12
varen1k322: posts small blind 50
Cyan Diogenes: posts big blind 100
*** HOLE CARDS ***
Dealt to phpro [Td Kd]
phpro: folds
jojosetubal: folds
Kaptahh: folds
Andrew Willian: folds
Maks19111979: raises 100 to 200
SuKKinho: folds
varen1k322: folds
Cyan Diogenes: calls 100
*** FLOP *** [3c 5h Jh]
Cyan Diogenes: checks
Maks19111979: bets 280
Cyan Diogenes: calls 280
*** TURN *** [3c 5h Jh] [8s]
Cyan Diogenes: checks
Maks19111979: bets 465
Cyan Diogenes: folds
Uncalled bet (465) returned to Maks19111979
Maks19111979 collected 1106 from pot
Maks19111979: doesn't show hand
*** SUMMARY ***
Total pot 1106 | Rake 0
Board [3c 5h Jh 8s]
Seat 1: jojosetubal folded before Flop (didn't bet)
Seat 2: Kaptahh folded before Flop (didn't bet)
Seat 3: Andrew Willian folded before Flop (didn't bet)
Seat 4: Maks19111979 collected (1106)
Seat 5: SuKKinho (button) folded before Flop (didn't bet)
Seat 7: varen1k322 (small blind) folded before Flop
Seat 8: Cyan Diogenes (big blind) folded on the Turn
Seat 9: phpro folded before Flop (didn't bet)


*********** # 4 **************
PokerStars Hand #257045883935: Tournament #3910307458, $0.98+$0.12 USD Hold'em No Limit - Level VI (50/100) - 2025/07/22 10:13:18 ET
Table '3910307458 12' 9-max Seat #7 is the button
Seat 1: jojosetubal (7803 in chips)
Seat 2: Kaptahh (8345 in chips)
Seat 3: Andrew Willian (1757 in chips)
Seat 4: Maks19111979 (3294 in chips)
Seat 5: SuKKinho (3906 in chips)
Seat 6: martelli1990 (3000 in chips)
Seat 7: varen1k322 (3002 in chips)
Seat 8: Cyan Diogenes (8528 in chips)
Seat 9: phpro (2968 in chips)
jojosetubal: posts the ante 12
Kaptahh: posts the ante 12
Andrew Willian: posts the ante 12
Maks19111979: posts the ante 12
SuKKinho: posts the ante 12
martelli1990: posts the ante 12
varen1k322: posts the ante 12
Cyan Diogenes: posts the ante 12
phpro: posts the ante 12
Cyan Diogenes: posts small blind 50
phpro: posts big blind 100
*** HOLE CARDS ***
Dealt to phpro [4c 5c]
jojosetubal: raises 100 to 200
Kaptahh: folds
Andrew Willian: folds
Maks19111979: calls 200
SuKKinho: folds
martelli1990: folds
varen1k322: folds
Cyan Diogenes: raises 700 to 900
phpro: folds
jojosetubal: calls 700
Maks19111979: calls 700
*** FLOP *** [2d Td Kd]
Cyan Diogenes: checks
jojosetubal: checks
Maks19111979: bets 960
Cyan Diogenes: folds
jojosetubal: calls 960
*** TURN *** [2d Td Kd] [Jc]
jojosetubal: checks
Maks19111979: bets 1422 and is all-in
jojosetubal: calls 1422
*** RIVER *** [2d Td Kd Jc] [3c]
*** SHOW DOWN ***
jojosetubal: shows [Qc Ad] (a straight, Ten to Ace)
Maks19111979: shows [As Qd] (a straight, Ten to Ace)
jojosetubal collected 3836 from pot
Maks19111979 collected 3836 from pot
*** SUMMARY ***
Total pot 7672 | Rake 0
Board [2d Td Kd Jc 3c]
Seat 1: jojosetubal showed [Qc Ad] and won (3836) with a straight, Ten to Ace
Seat 2: Kaptahh folded before Flop (didn't bet)
Seat 3: Andrew Willian folded before Flop (didn't bet)
Seat 4: Maks19111979 showed [As Qd] and won (3836) with a straight, Ten to Ace
Seat 5: SuKKinho folded before Flop (didn't bet)
Seat 6: martelli1990 folded before Flop (didn't bet)
Seat 7: varen1k322 (button) folded before Flop (didn't bet)
Seat 8: Cyan Diogenes (small blind) folded on the Flop
Seat 9: phpro (big blind) folded before Flop


*********** # 5 **************
PokerStars Hand #257045898300: Tournament #3910307458, $0.98+$0.12 USD Hold'em No Limit - Level VI (50/100) - 2025/07/22 10:14:57 ET
Table '3910307458 12' 9-max Seat #8 is the button
Seat 1: jojosetubal (8345 in chips)
Seat 2: Kaptahh (8333 in chips)
Seat 3: Andrew Willian (1745 in chips)
Seat 4: Maks19111979 (3836 in chips)
Seat 5: SuKKinho (3894 in chips)
Seat 6: martelli1990 (2988 in chips)
Seat 7: varen1k322 (2990 in chips)
Seat 8: Cyan Diogenes (7616 in chips)
Seat 9: phpro (2856 in chips)
jojosetubal: posts the ante 12
Kaptahh: posts the ante 12
Andrew Willian: posts the ante 12
Maks19111979: posts the ante 12
SuKKinho: posts the ante 12
martelli1990: posts the ante 12
varen1k322: posts the ante 12
Cyan Diogenes: posts the ante 12
phpro: posts the ante 12
phpro: posts small blind 50
jojosetubal: posts big blind 100
*** HOLE CARDS ***
Dealt to phpro [3h 4c]
Kaptahh: folds
Andrew Willian: folds
Maks19111979: folds
SuKKinho: raises 100 to 200
martelli1990: folds
varen1k322: folds
Cyan Diogenes: calls 200
phpro: folds
jojosetubal: folds
*** FLOP *** [Qs Td 2d]
SuKKinho: bets 349
Cyan Diogenes: calls 349
*** TURN *** [Qs Td 2d] [Ah]
SuKKinho: checks
Cyan Diogenes: bets 600
SuKKinho: raises 2733 to 3333 and is all-in
Cyan Diogenes: folds
Uncalled bet (2733) returned to SuKKinho
SuKKinho collected 2556 from pot
*** SUMMARY ***
Total pot 2556 | Rake 0
Board [Qs Td 2d Ah]
Seat 1: jojosetubal (big blind) folded before Flop
Seat 2: Kaptahh folded before Flop (didn't bet)
Seat 3: Andrew Willian folded before Flop (didn't bet)
Seat 4: Maks19111979 folded before Flop (didn't bet)
Seat 5: SuKKinho collected (2556)
Seat 6: martelli1990 folded before Flop (didn't bet)
Seat 7: varen1k322 folded before Flop (didn't bet)
Seat 8: Cyan Diogenes (button) folded on the Turn
Seat 9: phpro (small blind) folded before Flop


*********** # 6 **************
PokerStars Hand #257045912047: Tournament #3910307458, $0.98+$0.12 USD Hold'em No Limit - Level VI (50/100) - 2025/07/22 10:16:27 ET
Table '3910307458 12' 9-max Seat #9 is the button
Seat 1: jojosetubal (8233 in chips)
Seat 2: Kaptahh (8321 in chips)
Seat 3: Andrew Willian (1733 in chips)
Seat 4: Maks19111979 (3824 in chips)
Seat 5: SuKKinho (5289 in chips)
Seat 6: martelli1990 (2976 in chips)
Seat 7: varen1k322 (2978 in chips)
Seat 8: Cyan Diogenes (6455 in chips)
Seat 9: phpro (2794 in chips)
jojosetubal: posts the ante 12
Kaptahh: posts the ante 12
Andrew Willian: posts the ante 12
Maks19111979: posts the ante 12
SuKKinho: posts the ante 12
martelli1990: posts the ante 12
varen1k322: posts the ante 12
Cyan Diogenes: posts the ante 12
phpro: posts the ante 12
jojosetubal: posts small blind 50
Kaptahh: posts big blind 100
*** HOLE CARDS ***
Dealt to phpro [3d 7h]
Andrew Willian: folds
Maks19111979: folds
SuKKinho: folds
martelli1990: raises 100 to 200
varen1k322: calls 200
Cyan Diogenes: folds
phpro: folds
jojosetubal: folds
Kaptahh: folds
*** FLOP *** [4s 6s Qh]
martelli1990: bets 217
varen1k322: folds
Uncalled bet (217) returned to martelli1990
martelli1990 collected 658 from pot
martelli1990: doesn't show hand
*** SUMMARY ***
Total pot 658 | Rake 0
Board [4s 6s Qh]
Seat 1: jojosetubal (small blind) folded before Flop
Seat 2: Kaptahh (big blind) folded before Flop
Seat 3: Andrew Willian folded before Flop (didn't bet)
Seat 4: Maks19111979 folded before Flop (didn't bet)
Seat 5: SuKKinho folded before Flop (didn't bet)
Seat 6: martelli1990 collected (658)
Seat 7: varen1k322 folded on the Flop
Seat 8: Cyan Diogenes folded before Flop (didn't bet)
Seat 9: phpro (button) folded before Flop (didn't bet)


*********** # 7 **************
PokerStars Hand #257045919085: Tournament #3910307458, $0.98+$0.12 USD Hold'em No Limit - Level VI (50/100) - 2025/07/22 10:17:13 ET
Table '3910307458 12' 9-max Seat #1 is the button
Seat 1: jojosetubal (8171 in chips)
Seat 2: Kaptahh (8209 in chips)
Seat 3: Andrew Willian (1721 in chips)
Seat 4: Maks19111979 (3812 in chips)
Seat 5: SuKKinho (5277 in chips)
Seat 6: martelli1990 (3422 in chips)
Seat 7: varen1k322 (2766 in chips)
Seat 8: Cyan Diogenes (6443 in chips)
Seat 9: phpro (2782 in chips)
jojosetubal: posts the ante 12
Kaptahh: posts the ante 12
Andrew Willian: posts the ante 12
Maks19111979: posts the ante 12
SuKKinho: posts the ante 12
martelli1990: posts the ante 12
varen1k322: posts the ante 12
Cyan Diogenes: posts the ante 12
phpro: posts the ante 12
Kaptahh: posts small blind 50
Andrew Willian: posts big blind 100
*** HOLE CARDS ***
Dealt to phpro [8s 8h]
Maks19111979: raises 100 to 200
SuKKinho: folds
martelli1990: folds
varen1k322: folds
Cyan Diogenes: folds
phpro: calls 200
jojosetubal: calls 200
Kaptahh: folds
Andrew Willian: calls 100
*** FLOP *** [7s 6s 2c]
Andrew Willian: checks
Maks19111979: checks
phpro: bets 316
jojosetubal: calls 316
Andrew Willian: folds
Maks19111979: calls 316
*** TURN *** [7s 6s 2c] [Jd]
Maks19111979: checks
phpro: checks
jojosetubal: checks
*** RIVER *** [7s 6s 2c Jd] [Ac]
Maks19111979: checks
phpro: checks
jojosetubal: checks
*** SHOW DOWN ***
Maks19111979: shows [9h As] (a pair of Aces)
phpro: mucks hand
jojosetubal: mucks hand
Maks19111979 collected 1906 from pot
*** SUMMARY ***
Total pot 1906 | Rake 0
Board [7s 6s 2c Jd Ac]
Seat 1: jojosetubal (button) mucked [Qc 6c]
Seat 2: Kaptahh (small blind) folded before Flop
Seat 3: Andrew Willian (big blind) folded on the Flop
Seat 4: Maks19111979 showed [9h As] and won (1906) with a pair of Aces
Seat 5: SuKKinho folded before Flop (didn't bet)
Seat 6: martelli1990 folded before Flop (didn't bet)
Seat 7: varen1k322 folded before Flop (didn't bet)
Seat 8: Cyan Diogenes folded before Flop (didn't bet)
Seat 9: phpro mucked [8s 8h]


*********** # 8 **************
PokerStars Hand #257045933884: Tournament #3910307458, $0.98+$0.12 USD Hold'em No Limit - Level VI (50/100) - 2025/07/22 10:18:49 ET
Table '3910307458 12' 9-max Seat #2 is the button
Seat 1: jojosetubal (7643 in chips)
Seat 2: Kaptahh (8147 in chips)
Seat 3: Andrew Willian (1509 in chips)
Seat 4: Maks19111979 (5190 in chips)
Seat 5: SuKKinho (5265 in chips)
Seat 6: martelli1990 (3410 in chips)
Seat 7: varen1k322 (2754 in chips)
Seat 8: Cyan Diogenes (6431 in chips)
Seat 9: phpro (2254 in chips)
jojosetubal: posts the ante 12
Kaptahh: posts the ante 12
Andrew Willian: posts the ante 12
Maks19111979: posts the ante 12
SuKKinho: posts the ante 12
martelli1990: posts the ante 12
varen1k322: posts the ante 12
Cyan Diogenes: posts the ante 12
phpro: posts the ante 12
Andrew Willian: posts small blind 50
Maks19111979: posts big blind 100
*** HOLE CARDS ***
Dealt to phpro [Jd Qs]
SuKKinho: folds
martelli1990: folds
varen1k322: raises 100 to 200
Cyan Diogenes: folds
phpro: folds
jojosetubal: calls 200
Kaptahh: folds
Andrew Willian: folds
Maks19111979: folds
*** FLOP *** [Ks Qd Jh]
varen1k322: checks
jojosetubal: checks
*** TURN *** [Ks Qd Jh] [6h]
varen1k322: bets 329
jojosetubal: folds
Uncalled bet (329) returned to varen1k322
varen1k322 collected 658 from pot
*** SUMMARY ***
Total pot 658 | Rake 0
Board [Ks Qd Jh 6h]
Seat 1: jojosetubal folded on the Turn
Seat 2: Kaptahh (button) folded before Flop (didn't bet)
Seat 3: Andrew Willian (small blind) folded before Flop
Seat 4: Maks19111979 (big blind) folded before Flop
Seat 5: SuKKinho folded before Flop (didn't bet)
Seat 6: martelli1990 folded before Flop (didn't bet)
Seat 7: varen1k322 collected (658)
Seat 8: Cyan Diogenes folded before Flop (didn't bet)
Seat 9: phpro folded before Flop (didn't bet)


*********** # 9 **************
PokerStars Hand #257045940964: Tournament #3910307458, $0.98+$0.12 USD Hold'em No Limit - Level VI (50/100) - 2025/07/22 10:19:35 ET
Table '3910307458 12' 9-max Seat #3 is the button
Seat 1: jojosetubal (7431 in chips)
Seat 2: Kaptahh (8135 in chips)
Seat 3: Andrew Willian (1447 in chips)
Seat 4: Maks19111979 (5078 in chips)
Seat 5: SuKKinho (5253 in chips)
Seat 6: martelli1990 (3398 in chips)
Seat 7: varen1k322 (3200 in chips)
Seat 8: Cyan Diogenes (6419 in chips)
Seat 9: phpro (2242 in chips)
jojosetubal: posts the ante 12
Kaptahh: posts the ante 12
Andrew Willian: posts the ante 12
Maks19111979: posts the ante 12
SuKKinho: posts the ante 12
martelli1990: posts the ante 12
varen1k322: posts the ante 12
Cyan Diogenes: posts the ante 12
phpro: posts the ante 12
Maks19111979: posts small blind 50
SuKKinho: posts big blind 100
*** HOLE CARDS ***
Dealt to phpro [Qs Kd]
martelli1990: raises 100 to 200
varen1k322: folds
Cyan Diogenes: folds
phpro: calls 200
jojosetubal: folds
Kaptahh: folds
Andrew Willian: folds
Maks19111979: folds
SuKKinho: raises 630 to 830
martelli1990: calls 630
phpro: folds
*** FLOP *** [5d 6h Ad]
SuKKinho: checks
martelli1990: bets 666
SuKKinho: raises 3745 to 4411 and is all-in
martelli1990: folds
Uncalled bet (3745) returned to SuKKinho
SuKKinho collected 3350 from pot
*** SUMMARY ***
Total pot 3350 | Rake 0
Board [5d 6h Ad]
Seat 1: jojosetubal folded before Flop (didn't bet)
Seat 2: Kaptahh folded before Flop (didn't bet)
Seat 3: Andrew Willian (button) folded before Flop (didn't bet)
Seat 4: Maks19111979 (small blind) folded before Flop
Seat 5: SuKKinho (big blind) collected (3350)
Seat 6: martelli1990 folded on the Flop
Seat 7: varen1k322 folded before Flop (didn't bet)
Seat 8: Cyan Diogenes folded before Flop (didn't bet)
Seat 9: phpro folded before Flop


*********** # 10 **************
PokerStars Hand #257045958227: Tournament #3910307458, $0.98+$0.12 USD Hold'em No Limit - Level VI (50/100) - 2025/07/22 10:21:26 ET
Table '3910307458 12' 9-max Seat #4 is the button
Seat 2: Kaptahh (8123 in chips)
Seat 3: Andrew Willian (1435 in chips)
Seat 4: Maks19111979 (5016 in chips)
Seat 5: SuKKinho (7095 in chips)
Seat 6: martelli1990 (1890 in chips)
Seat 7: varen1k322 (3188 in chips)
Seat 8: Cyan Diogenes (6407 in chips)
Seat 9: phpro (2030 in chips)
Kaptahh: posts the ante 12
Andrew Willian: posts the ante 12
Maks19111979: posts the ante 12
SuKKinho: posts the ante 12
martelli1990: posts the ante 12
varen1k322: posts the ante 12
Cyan Diogenes: posts the ante 12
phpro: posts the ante 12
SuKKinho: posts small blind 50
martelli1990: posts big blind 100
*** HOLE CARDS ***
Dealt to phpro [4s Td]
varen1k322: folds
Cyan Diogenes: folds
phpro: folds
Kaptahh: folds
Andrew Willian: raises 1323 to 1423 and is all-in
Maks19111979: calls 1423
SuKKinho: folds
martelli1990: folds
*** FLOP *** [Kd 6c 7d]
*** TURN *** [Kd 6c 7d] [2d]
*** RIVER *** [Kd 6c 7d 2d] [Jh]
*** SHOW DOWN ***
Andrew Willian: shows [Qd Js] (a pair of Jacks)
Maks19111979: shows [Th As] (high card Ace)
Andrew Willian collected 3092 from pot
Zahard23 is disconnected
*** SUMMARY ***
Total pot 3092 | Rake 0
Board [Kd 6c 7d 2d Jh]
Seat 2: Kaptahh folded before Flop (didn't bet)
Seat 3: Andrew Willian showed [Qd Js] and won (3092) with a pair of Jacks
Seat 4: Maks19111979 (button) showed [Th As] and lost with high card Ace
Seat 5: SuKKinho (small blind) folded before Flop
Seat 6: martelli1990 (big blind) folded before Flop
Seat 7: varen1k322 folded before Flop (didn't bet)
Seat 8: Cyan Diogenes folded before Flop (didn't bet)
Seat 9: phpro folded before Flop (didn't bet)


*********** # 11 **************
PokerStars Hand #257045965983: Tournament #3910307458, $0.98+$0.12 USD Hold'em No Limit - Level VII (60/120) - 2025/07/22 10:22:17 ET
Table '3910307458 12' 9-max Seat #5 is the button
Seat 1: Zahard23 (3000 in chips)
Seat 2: Kaptahh (8111 in chips)
Seat 3: Andrew Willian (3092 in chips)
Seat 4: Maks19111979 (3581 in chips)
Seat 5: SuKKinho (7033 in chips)
Seat 6: martelli1990 (1778 in chips)
Seat 7: varen1k322 (3176 in chips)
Seat 8: Cyan Diogenes (6395 in chips)
Seat 9: phpro (2018 in chips)
Zahard23: posts the ante 15
Kaptahh: posts the ante 15
Andrew Willian: posts the ante 15
Maks19111979: posts the ante 15
SuKKinho: posts the ante 15
martelli1990: posts the ante 15
varen1k322: posts the ante 15
Cyan Diogenes: posts the ante 15
phpro: posts the ante 15
martelli1990: posts small blind 60
varen1k322: posts big blind 120
*** HOLE CARDS ***
Dealt to phpro [As Jh]
Cyan Diogenes: folds
phpro: raises 120 to 240
Zahard23: raises 120 to 360
Kaptahh: folds
Andrew Willian: folds
Maks19111979: folds
SuKKinho: folds
martelli1990: folds
varen1k322: folds
phpro: calls 120
*** FLOP *** [Qs 2h 9s]
phpro: checks
Zahard23: checks
*** TURN *** [Qs 2h 9s] [9h]
phpro: checks
Zahard23: bets 240
phpro: raises 240 to 480
Zahard23: calls 240
*** RIVER *** [Qs 2h 9s 9h] [5s]
phpro: bets 658
Zahard23: calls 658
*** SHOW DOWN ***
phpro: shows [As Jh] (a pair of Nines)
Zahard23: shows [2c Ac] (two pair, Nines and Deuces)
Zahard23 collected 3311 from pot
*** SUMMARY ***
Total pot 3311 | Rake 0
Board [Qs 2h 9s 9h 5s]
Seat 1: Zahard23 showed [2c Ac] and won (3311) with two pair, Nines and Deuces
Seat 2: Kaptahh folded before Flop (didn't bet)
Seat 3: Andrew Willian folded before Flop (didn't bet)
Seat 4: Maks19111979 folded before Flop (didn't bet)
Seat 5: SuKKinho (button) folded before Flop (didn't bet)
Seat 6: martelli1990 (small blind) folded before Flop
Seat 7: varen1k322 (big blind) folded before Flop
Seat 8: Cyan Diogenes folded before Flop (didn't bet)
Seat 9: phpro showed [As Jh] and lost with a pair of Nines


*********** # 12 **************
PokerStars Hand #257045975775: Tournament #3910307458, $0.98+$0.12 USD Hold'em No Limit - Level VII (60/120) - 2025/07/22 10:23:20 ET
Table '3910307458 12' 9-max Seat #6 is the button
Seat 1: Zahard23 (4798 in chips)
Seat 2: Kaptahh (8096 in chips)
Seat 3: Andrew Willian (3077 in chips)
Seat 4: Maks19111979 (3566 in chips)
Seat 5: SuKKinho (7018 in chips)
Seat 6: martelli1990 (1703 in chips)
Seat 7: varen1k322 (3041 in chips)
Seat 8: Cyan Diogenes (6380 in chips)
Seat 9: phpro (505 in chips)
Zahard23: posts the ante 15
Kaptahh: posts the ante 15
Andrew Willian: posts the ante 15
Maks19111979: posts the ante 15
SuKKinho: posts the ante 15
martelli1990: posts the ante 15
varen1k322: posts the ante 15
Cyan Diogenes: posts the ante 15
phpro: posts the ante 15
varen1k322: posts small blind 60
Cyan Diogenes: posts big blind 120
*** HOLE CARDS ***
Dealt to phpro [As 8d]
phpro: folds
Zahard23: calls 120
Kaptahh: folds
Andrew Willian: raises 300 to 420
Maks19111979: folds
SuKKinho: folds
martelli1990: folds
varen1k322: calls 360
Cyan Diogenes: folds
Zahard23: calls 300
*** FLOP *** [6h Tc 4c]
varen1k322: checks
Zahard23: checks
Andrew Willian: checks
*** TURN *** [6h Tc 4c] [7d]
varen1k322: checks
Zahard23: checks
Andrew Willian: checks
*** RIVER *** [6h Tc 4c 7d] [9h]
varen1k322: checks
Zahard23: checks
Andrew Willian: checks
*** SHOW DOWN ***
varen1k322: shows [Qs 9s] (a pair of Nines)
Zahard23: mucks hand
Andrew Willian: mucks hand
varen1k322 collected 1515 from pot
*** SUMMARY ***
Total pot 1515 | Rake 0
Board [6h Tc 4c 7d 9h]
Seat 1: Zahard23 mucked [5h 2d]
Seat 2: Kaptahh folded before Flop (didn't bet)
Seat 3: Andrew Willian mucked [Kd Jc]
Seat 4: Maks19111979 folded before Flop (didn't bet)
Seat 5: SuKKinho folded before Flop (didn't bet)
Seat 6: martelli1990 (button) folded before Flop (didn't bet)
Seat 7: varen1k322 (small blind) showed [Qs 9s] and won (1515) with a pair of Nines
Seat 8: Cyan Diogenes (big blind) folded before Flop
Seat 9: phpro folded before Flop (didn't bet)


*********** # 13 **************
PokerStars Hand #257045989172: Tournament #3910307458, $0.98+$0.12 USD Hold'em No Limit - Level VII (60/120) - 2025/07/22 10:24:47 ET
Table '3910307458 12' 9-max Seat #7 is the button
Seat 1: Zahard23 (4363 in chips)
Seat 2: Kaptahh (8081 in chips)
Seat 3: Andrew Willian (2642 in chips)
Seat 4: Maks19111979 (3551 in chips)
Seat 5: SuKKinho (7003 in chips)
Seat 6: martelli1990 (1688 in chips)
Seat 7: varen1k322 (4121 in chips)
Seat 8: Cyan Diogenes (6245 in chips)
Seat 9: phpro (490 in chips)
Zahard23: posts the ante 15
Kaptahh: posts the ante 15
Andrew Willian: posts the ante 15
Maks19111979: posts the ante 15
SuKKinho: posts the ante 15
martelli1990: posts the ante 15
varen1k322: posts the ante 15
Cyan Diogenes: posts the ante 15
phpro: posts the ante 15
Cyan Diogenes: posts small blind 60
phpro: posts big blind 120
*** HOLE CARDS ***
Dealt to phpro [8h Kd]
Zahard23: folds
Kaptahh: folds
Andrew Willian: folds
Maks19111979: folds
SuKKinho: folds
martelli1990: raises 120 to 240
varen1k322: raises 360 to 600
Cyan Diogenes: calls 540
phpro: folds
martelli1990: calls 360
*** FLOP *** [Js 9c 8s]
Cyan Diogenes: checks
martelli1990: checks
varen1k322: checks
*** TURN *** [Js 9c 8s] [Qs]
Cyan Diogenes: checks
martelli1990: bets 1073 and is all-in
varen1k322: calls 1073
Cyan Diogenes: folds
*** RIVER *** [Js 9c 8s Qs] [Tc]
*** SHOW DOWN ***
martelli1990: shows [Qh 7h] (a straight, Eight to Queen)
varen1k322: shows [Kh As] (a straight, Ten to Ace)
varen1k322 collected 4201 from pot
martelli1990 finished the tournament in 205th place
*** SUMMARY ***
Total pot 4201 | Rake 0
Board [Js 9c 8s Qs Tc]
Seat 1: Zahard23 folded before Flop (didn't bet)
Seat 2: Kaptahh folded before Flop (didn't bet)
Seat 3: Andrew Willian folded before Flop (didn't bet)
Seat 4: Maks19111979 folded before Flop (didn't bet)
Seat 5: SuKKinho folded before Flop (didn't bet)
Seat 6: martelli1990 showed [Qh 7h] and lost with a straight, Eight to Queen
Seat 7: varen1k322 (button) showed [Kh As] and won (4201) with a straight, Ten to Ace
Seat 8: Cyan Diogenes (small blind) folded on the Turn
Seat 9: phpro (big blind) folded before Flop


*********** # 14 **************
PokerStars Hand #257045999912: Tournament #3910307458, $0.98+$0.12 USD Hold'em No Limit - Level VII (60/120) - 2025/07/22 10:25:57 ET
Table '3910307458 12' 9-max Seat #8 is the button
Seat 1: Zahard23 (4348 in chips)
Seat 2: Kaptahh (8066 in chips)
Seat 3: Andrew Willian (2627 in chips)
Seat 4: Maks19111979 (3536 in chips)
Seat 5: SuKKinho (6988 in chips)
Seat 7: varen1k322 (6634 in chips)
Seat 8: Cyan Diogenes (5630 in chips)
Seat 9: phpro (355 in chips)
Zahard23: posts the ante 15
Kaptahh: posts the ante 15
Andrew Willian: posts the ante 15
Maks19111979: posts the ante 15
SuKKinho: posts the ante 15
varen1k322: posts the ante 15
Cyan Diogenes: posts the ante 15
phpro: posts the ante 15
phpro: posts small blind 60
Zahard23: posts big blind 120
*** HOLE CARDS ***
Dealt to phpro [9h 6s]
Kaptahh: folds
Andrew Willian: raises 120 to 240
Maks19111979: folds
SuKKinho: calls 240
varen1k322: folds
Cyan Diogenes: folds
phpro: folds
Zahard23: folds
*** FLOP *** [4c 8s Th]
Andrew Willian: checks
SuKKinho: bets 179
Andrew Willian: calls 179
*** TURN *** [4c 8s Th] [Td]
Andrew Willian: checks
SuKKinho: checks
*** RIVER *** [4c 8s Th Td] [Qd]
Andrew Willian: checks
SuKKinho: checks
*** SHOW DOWN ***
Andrew Willian: shows [As Ks] (a pair of Tens)
SuKKinho: shows [Qh Kd] (two pair, Queens and Tens)
SuKKinho collected 1138 from pot
*** SUMMARY ***
Total pot 1138 | Rake 0
Board [4c 8s Th Td Qd]
Seat 1: Zahard23 (big blind) folded before Flop
Seat 2: Kaptahh folded before Flop (didn't bet)
Seat 3: Andrew Willian showed [As Ks] and lost with a pair of Tens
Seat 4: Maks19111979 folded before Flop (didn't bet)
Seat 5: SuKKinho showed [Qh Kd] and won (1138) with two pair, Queens and Tens
Seat 7: varen1k322 folded before Flop (didn't bet)
Seat 8: Cyan Diogenes (button) folded before Flop (didn't bet)
Seat 9: phpro (small blind) folded before Flop


*********** # 15 **************
PokerStars Hand #257046008859: Tournament #3910307458, $0.98+$0.12 USD Hold'em No Limit - Level VII (60/120) - 2025/07/22 10:26:55 ET
Table '3910307458 12' 9-max Seat #9 is the button
Seat 1: Zahard23 (4213 in chips)
Seat 2: Kaptahh (8051 in chips)
Seat 3: Andrew Willian (2193 in chips)
Seat 4: Maks19111979 (3521 in chips)
Seat 5: SuKKinho (7692 in chips)
Seat 7: varen1k322 (6619 in chips)
Seat 8: Cyan Diogenes (5615 in chips)
Seat 9: phpro (280 in chips)
Zahard23: posts the ante 15
Kaptahh: posts the ante 15
Andrew Willian: posts the ante 15
Maks19111979: posts the ante 15
SuKKinho: posts the ante 15
varen1k322: posts the ante 15
Cyan Diogenes: posts the ante 15
phpro: posts the ante 15
Zahard23: posts small blind 60
Kaptahh: posts big blind 120
*** HOLE CARDS ***
Dealt to phpro [3d 8h]
Andrew Willian: folds
Maks19111979: folds
SuKKinho: folds
varen1k322: folds
Cyan Diogenes: folds
phpro: raises 120 to 240
Zahard23: raises 120 to 360
Kaptahh: folds
phpro: calls 25 and is all-in
Uncalled bet (95) returned to Zahard23
*** FLOP *** [4h Ah 9d]
*** TURN *** [4h Ah 9d] [7s]
*** RIVER *** [4h Ah 9d 7s] [Td]
*** SHOW DOWN ***
Zahard23: shows [Th Ac] (two pair, Aces and Tens)
phpro: shows [3d 8h] (high card Ace)
Zahard23 collected 770 from pot
phpro finished the tournament in 199th place
*** SUMMARY ***
Total pot 770 | Rake 0
Board [4h Ah 9d 7s Td]
Seat 1: Zahard23 (small blind) showed [Th Ac] and won (770) with two pair, Aces and Tens
Seat 2: Kaptahh (big blind) folded before Flop
Seat 3: Andrew Willian folded before Flop (didn't bet)
Seat 4: Maks19111979 folded before Flop (didn't bet)
Seat 5: SuKKinho folded before Flop (didn't bet)
Seat 7: varen1k322 folded before Flop (didn't bet)
Seat 8: Cyan Diogenes folded before Flop (didn't bet)
Seat 9: phpro (button) showed [3d 8h] and lost with high card Ace


*********** # 16 **************
PokerStars Hand #257046025443: Tournament #3910307458, $0.98+$0.12 USD Hold'em No Limit - Level VII (60/120) - 2025/07/22 10:28:44 ET
Table '3910307458 12' 9-max Seat #2 is the button
Seat 1: Zahard23 (4688 in chips)
Seat 2: Kaptahh (7841 in chips)
Seat 3: Andrew Willian (1083 in chips)
Seat 4: Maks19111979 (3491 in chips)
Seat 5: SuKKinho (7662 in chips)
Seat 6: phpro (3000 in chips)
Seat 7: varen1k322 (6589 in chips)
Seat 8: Cyan Diogenes (6830 in chips)
Zahard23: posts the ante 15
Kaptahh: posts the ante 15
Andrew Willian: posts the ante 15
Maks19111979: posts the ante 15
SuKKinho: posts the ante 15
phpro: posts the ante 15
varen1k322: posts the ante 15
Cyan Diogenes: posts the ante 15
Andrew Willian: posts small blind 60
Maks19111979: posts big blind 120
*** HOLE CARDS ***
Dealt to phpro [7d 3d]
SuKKinho: raises 144 to 264
phpro: folds
varen1k322: calls 264
Cyan Diogenes: calls 264
Zahard23: calls 264
Kaptahh: folds
Andrew Willian: folds
Maks19111979: folds
*** FLOP *** [4d Qd Jd]
SuKKinho: checks
varen1k322: checks
Cyan Diogenes: checks
Zahard23: bets 240
SuKKinho: calls 240
varen1k322: calls 240
Cyan Diogenes: calls 240
*** TURN *** [4d Qd Jd] [8h]
SuKKinho: checks
varen1k322: checks
Cyan Diogenes: checks
Zahard23: bets 1560
SuKKinho: folds
varen1k322: folds
Cyan Diogenes: folds
Uncalled bet (1560) returned to Zahard23
Zahard23 collected 2316 from pot
Zahard23: doesn't show hand
*** SUMMARY ***
Total pot 2316 | Rake 0
Board [4d Qd Jd 8h]
Seat 1: Zahard23 collected (2316)
Seat 2: Kaptahh (button) folded before Flop (didn't bet)
Seat 3: Andrew Willian (small blind) folded before Flop
Seat 4: Maks19111979 (big blind) folded before Flop
Seat 5: SuKKinho folded on the Turn
Seat 6: phpro folded before Flop (didn't bet)
Seat 7: varen1k322 folded on the Turn
Seat 8: Cyan Diogenes folded on the Turn


*********** # 17 **************
PokerStars Hand #257046040965: Tournament #3910307458, $0.98+$0.12 USD Hold'em No Limit - Level VII (60/120) - 2025/07/22 10:30:25 ET
Table '3910307458 12' 9-max Seat #3 is the button
Seat 1: Zahard23 (6485 in chips)
Seat 2: Kaptahh (7826 in chips)
Seat 3: Andrew Willian (1008 in chips)
Seat 4: Maks19111979 (3356 in chips)
Seat 5: SuKKinho (7143 in chips)
Seat 6: phpro (2985 in chips)
Seat 7: varen1k322 (6070 in chips)
Seat 8: Cyan Diogenes (6311 in chips)
Zahard23: posts the ante 15
Kaptahh: posts the ante 15
Andrew Willian: posts the ante 15
Maks19111979: posts the ante 15
SuKKinho: posts the ante 15
phpro: posts the ante 15
varen1k322: posts the ante 15
Cyan Diogenes: posts the ante 15
Maks19111979: posts small blind 60
SuKKinho: posts big blind 120
*** HOLE CARDS ***
Dealt to phpro [2c As]
phpro: folds
varen1k322: folds
Cyan Diogenes: folds
Zahard23: folds
Kaptahh: folds
Andrew Willian: raises 873 to 993 and is all-in
Maks19111979: folds
SuKKinho: folds
Uncalled bet (873) returned to Andrew Willian
Andrew Willian collected 420 from pot
*** SUMMARY ***
Total pot 420 | Rake 0
Seat 1: Zahard23 folded before Flop (didn't bet)
Seat 2: Kaptahh folded before Flop (didn't bet)
Seat 3: Andrew Willian (button) collected (420)
Seat 4: Maks19111979 (small blind) folded before Flop
Seat 5: SuKKinho (big blind) folded before Flop
Seat 6: phpro folded before Flop (didn't bet)
Seat 7: varen1k322 folded before Flop (didn't bet)
Seat 8: Cyan Diogenes folded before Flop (didn't bet)


*********** # 18 **************
PokerStars Hand #257046046366: Tournament #3910307458, $0.98+$0.12 USD Hold'em No Limit - Level VII (60/120) - 2025/07/22 10:31:00 ET
Table '3910307458 12' 9-max Seat #4 is the button
Seat 1: Zahard23 (6470 in chips)
Seat 2: Kaptahh (7811 in chips)
Seat 3: Andrew Willian (1293 in chips)
Seat 4: Maks19111979 (3281 in chips)
Seat 5: SuKKinho (7008 in chips)
Seat 6: phpro (2970 in chips)
Seat 7: varen1k322 (6055 in chips)
Seat 8: Cyan Diogenes (6296 in chips)
Zahard23: posts the ante 15
Kaptahh: posts the ante 15
Andrew Willian: posts the ante 15
Maks19111979: posts the ante 15
SuKKinho: posts the ante 15
phpro: posts the ante 15
varen1k322: posts the ante 15
Cyan Diogenes: posts the ante 15
SuKKinho: posts small blind 60
phpro: posts big blind 120
*** HOLE CARDS ***
Dealt to phpro [5d 8s]
varen1k322: raises 156 to 276
Cyan Diogenes: folds
Zahard23: folds
Kaptahh: folds
Andrew Willian: folds
Maks19111979: folds
SuKKinho: folds
phpro: folds
Uncalled bet (156) returned to varen1k322
varen1k322 collected 420 from pot
*** SUMMARY ***
Total pot 420 | Rake 0
Seat 1: Zahard23 folded before Flop (didn't bet)
Seat 2: Kaptahh folded before Flop (didn't bet)
Seat 3: Andrew Willian folded before Flop (didn't bet)
Seat 4: Maks19111979 (button) folded before Flop (didn't bet)
Seat 5: SuKKinho (small blind) folded before Flop
Seat 6: phpro (big blind) folded before Flop
Seat 7: varen1k322 collected (420)
Seat 8: Cyan Diogenes folded before Flop (didn't bet)


*********** # 19 **************
PokerStars Hand #257046050855: Tournament #3910307458, $0.98+$0.12 USD Hold'em No Limit - Level VII (60/120) - 2025/07/22 10:31:29 ET
Table '3910307458 12' 9-max Seat #5 is the button
Seat 1: Zahard23 (6455 in chips)
Seat 2: Kaptahh (7796 in chips)
Seat 3: Andrew Willian (1278 in chips)
Seat 4: Maks19111979 (3266 in chips)
Seat 5: SuKKinho (6933 in chips)
Seat 6: phpro (2835 in chips)
Seat 7: varen1k322 (6340 in chips)
Seat 8: Cyan Diogenes (6281 in chips)
Zahard23: posts the ante 15
Kaptahh: posts the ante 15
Andrew Willian: posts the ante 15
Maks19111979: posts the ante 15
SuKKinho: posts the ante 15
phpro: posts the ante 15
varen1k322: posts the ante 15
Cyan Diogenes: posts the ante 15
phpro: posts small blind 60
varen1k322: posts big blind 120
*** HOLE CARDS ***
Dealt to phpro [3d 4s]
Cyan Diogenes: folds
Zahard23: folds
Kaptahh: folds
Andrew Willian: folds
Maks19111979: folds
SuKKinho: raises 120 to 240
phpro: folds
varen1k322: calls 120
*** FLOP *** [6c 2h Th]
varen1k322: checks
SuKKinho: bets 218
varen1k322: calls 218
*** TURN *** [6c 2h Th] [9s]
varen1k322: checks
SuKKinho: bets 422
varen1k322: calls 422
*** RIVER *** [6c 2h Th 9s] [8h]
varen1k322: bets 1940
SuKKinho: calls 1940
*** SHOW DOWN ***
varen1k322: shows [Ks 7h] (a straight, Six to Ten)
SuKKinho: shows [7d Ad] (a straight, Six to Ten)
varen1k322 collected 2910 from pot
SuKKinho collected 2910 from pot
*** SUMMARY ***
Total pot 5820 | Rake 0
Board [6c 2h Th 9s 8h]
Seat 1: Zahard23 folded before Flop (didn't bet)
Seat 2: Kaptahh folded before Flop (didn't bet)
Seat 3: Andrew Willian folded before Flop (didn't bet)
Seat 4: Maks19111979 folded before Flop (didn't bet)
Seat 5: SuKKinho (button) showed [7d Ad] and won (2910) with a straight, Six to Ten
Seat 6: phpro (small blind) folded before Flop
Seat 7: varen1k322 (big blind) showed [Ks 7h] and won (2910) with a straight, Six to Ten
Seat 8: Cyan Diogenes folded before Flop (didn't bet)


*********** # 20 **************
PokerStars Hand #257046057865: Tournament #3910307458, $0.98+$0.12 USD Hold'em No Limit - Level VIII (75/150) - 2025/07/22 10:32:14 ET
Table '3910307458 12' 9-max Seat #6 is the button
Seat 1: Zahard23 (6440 in chips)
Seat 2: Kaptahh (7781 in chips)
Seat 3: Andrew Willian (1263 in chips)
Seat 4: Maks19111979 (3251 in chips)
Seat 5: SuKKinho (7008 in chips)
Seat 6: phpro (2760 in chips)
Seat 7: varen1k322 (6415 in chips)
Seat 8: Cyan Diogenes (6266 in chips)
Zahard23: posts the ante 20
Kaptahh: posts the ante 20
Andrew Willian: posts the ante 20
Maks19111979: posts the ante 20
SuKKinho: posts the ante 20
phpro: posts the ante 20
varen1k322: posts the ante 20
Cyan Diogenes: posts the ante 20
varen1k322: posts small blind 75
Cyan Diogenes: posts big blind 150
*** HOLE CARDS ***
Dealt to phpro [9d 5d]
Zahard23: raises 300 to 450
Kaptahh: folds
Andrew Willian: raises 793 to 1243 and is all-in
Maks19111979: folds
SuKKinho: folds
phpro: folds
varen1k322: folds
Cyan Diogenes: folds
Zahard23: calls 793
*** FLOP *** [2c 9c 9s]
*** TURN *** [2c 9c 9s] [2h]
*** RIVER *** [2c 9c 9s 2h] [Ac]
*** SHOW DOWN ***
Zahard23: shows [Td Ks] (two pair, Nines and Deuces)
Andrew Willian: shows [5c 5s] (two pair, Nines and Fives)
Andrew Willian collected 2871 from pot
*** SUMMARY ***
Total pot 2871 | Rake 0
Board [2c 9c 9s 2h Ac]
Seat 1: Zahard23 showed [Td Ks] and lost with two pair, Nines and Deuces
Seat 2: Kaptahh folded before Flop (didn't bet)
Seat 3: Andrew Willian showed [5c 5s] and won (2871) with two pair, Nines and Fives
Seat 4: Maks19111979 folded before Flop (didn't bet)
Seat 5: SuKKinho folded before Flop (didn't bet)
Seat 6: phpro (button) folded before Flop (didn't bet)
Seat 7: varen1k322 (small blind) folded before Flop
Seat 8: Cyan Diogenes (big blind) folded before Flop


*********** # 21 **************
PokerStars Hand #257046063823: Tournament #3910307458, $0.98+$0.12 USD Hold'em No Limit - Level VIII (75/150) - 2025/07/22 10:32:52 ET
Table '3910307458 12' 9-max Seat #7 is the button
Seat 1: Zahard23 (5177 in chips)
Seat 2: Kaptahh (7761 in chips)
Seat 3: Andrew Willian (2871 in chips)
Seat 4: Maks19111979 (3231 in chips)
Seat 5: SuKKinho (6988 in chips)
Seat 6: phpro (2740 in chips)
Seat 7: varen1k322 (6320 in chips)
Seat 8: Cyan Diogenes (6096 in chips)
Zahard23: posts the ante 20
Kaptahh: posts the ante 20
Andrew Willian: posts the ante 20
Maks19111979: posts the ante 20
SuKKinho: posts the ante 20
phpro: posts the ante 20
varen1k322: posts the ante 20
Cyan Diogenes: posts the ante 20
Cyan Diogenes: posts small blind 75
Zahard23: posts big blind 150
*** HOLE CARDS ***
Dealt to phpro [9s 3c]
Kaptahh: folds
Andrew Willian: folds
Maks19111979: raises 150 to 300
SuKKinho: folds
phpro: folds
varen1k322: folds
Cyan Diogenes: folds
Zahard23: folds
Uncalled bet (150) returned to Maks19111979
Maks19111979 collected 535 from pot
Maks19111979: doesn't show hand
*** SUMMARY ***
Total pot 535 | Rake 0
Seat 1: Zahard23 (big blind) folded before Flop
Seat 2: Kaptahh folded before Flop (didn't bet)
Seat 3: Andrew Willian folded before Flop (didn't bet)
Seat 4: Maks19111979 collected (535)
Seat 5: SuKKinho folded before Flop (didn't bet)
Seat 6: phpro folded before Flop (didn't bet)
Seat 7: varen1k322 (button) folded before Flop (didn't bet)
Seat 8: Cyan Diogenes (small blind) folded before Flop


*********** # 22 **************
PokerStars Hand #257046068384: Tournament #3910307458, $0.98+$0.12 USD Hold'em No Limit - Level VIII (75/150) - 2025/07/22 10:33:21 ET
Table '3910307458 12' 9-max Seat #8 is the button
Seat 1: Zahard23 (5007 in chips)
Seat 2: Kaptahh (7741 in chips)
Seat 3: Andrew Willian (2851 in chips)
Seat 4: Maks19111979 (3596 in chips)
Seat 5: SuKKinho (6968 in chips)
Seat 6: phpro (2720 in chips)
Seat 7: varen1k322 (6300 in chips)
Seat 8: Cyan Diogenes (6001 in chips)
Zahard23: posts the ante 20
Kaptahh: posts the ante 20
Andrew Willian: posts the ante 20
Maks19111979: posts the ante 20
SuKKinho: posts the ante 20
phpro: posts the ante 20
varen1k322: posts the ante 20
Cyan Diogenes: posts the ante 20
Zahard23: posts small blind 75
Kaptahh: posts big blind 150
*** HOLE CARDS ***
Dealt to phpro [5s Kd]
Andrew Willian: folds
Maks19111979: folds
SuKKinho: folds
phpro: folds
varen1k322: raises 300 to 450
Cyan Diogenes: calls 450
Zahard23: calls 375
Kaptahh: folds
*** FLOP *** [8c 2s Th]
Zahard23: checks
varen1k322: checks
Cyan Diogenes: bets 750
Zahard23: folds
varen1k322: folds
Uncalled bet (750) returned to Cyan Diogenes
Cyan Diogenes collected 1660 from pot
Cyan Diogenes: doesn't show hand
*** SUMMARY ***
Total pot 1660 | Rake 0
Board [8c 2s Th]
Seat 1: Zahard23 (small blind) folded on the Flop
Seat 2: Kaptahh (big blind) folded before Flop
Seat 3: Andrew Willian folded before Flop (didn't bet)
Seat 4: Maks19111979 folded before Flop (didn't bet)
Seat 5: SuKKinho folded before Flop (didn't bet)
Seat 6: phpro folded before Flop (didn't bet)
Seat 7: varen1k322 folded on the Flop
Seat 8: Cyan Diogenes (button) collected (1660)


*********** # 23 **************
PokerStars Hand #257046076063: Tournament #3910307458, $0.98+$0.12 USD Hold'em No Limit - Level VIII (75/150) - 2025/07/22 10:34:10 ET
Table '3910307458 12' 9-max Seat #1 is the button
Seat 1: Zahard23 (4537 in chips)
Seat 2: Kaptahh (7571 in chips)
Seat 3: Andrew Willian (2831 in chips)
Seat 4: Maks19111979 (3576 in chips)
Seat 5: SuKKinho (6948 in chips)
Seat 6: phpro (2700 in chips)
Seat 7: varen1k322 (5830 in chips)
Seat 8: Cyan Diogenes (7191 in chips)
Zahard23: posts the ante 20
Kaptahh: posts the ante 20
Andrew Willian: posts the ante 20
Maks19111979: posts the ante 20
SuKKinho: posts the ante 20
phpro: posts the ante 20
varen1k322: posts the ante 20
Cyan Diogenes: posts the ante 20
Kaptahh: posts small blind 75
Andrew Willian: posts big blind 150
*** HOLE CARDS ***
Dealt to phpro [Qh 5s]
Maks19111979: folds
SuKKinho: folds
phpro: folds
varen1k322: raises 150 to 300
Cyan Diogenes: raises 150 to 450
Zahard23: folds
Kaptahh: folds
Andrew Willian: folds
varen1k322: calls 150
*** FLOP *** [5d Ks 4c]
varen1k322: checks
Cyan Diogenes: bets 750
varen1k322: folds
Uncalled bet (750) returned to Cyan Diogenes
Cyan Diogenes collected 1285 from pot
Cyan Diogenes: doesn't show hand
*** SUMMARY ***
Total pot 1285 | Rake 0
Board [5d Ks 4c]
Seat 1: Zahard23 (button) folded before Flop (didn't bet)
Seat 2: Kaptahh (small blind) folded before Flop
Seat 3: Andrew Willian (big blind) folded before Flop
Seat 4: Maks19111979 folded before Flop (didn't bet)
Seat 5: SuKKinho folded before Flop (didn't bet)
Seat 6: phpro folded before Flop (didn't bet)
Seat 7: varen1k322 folded on the Flop
Seat 8: Cyan Diogenes collected (1285)


*********** # 24 **************
PokerStars Hand #257046087436: Tournament #3910307458, $0.98+$0.12 USD Hold'em No Limit - Level VIII (75/150) - 2025/07/22 10:35:22 ET
Table '3910307458 12' 9-max Seat #2 is the button
Seat 1: Zahard23 (4517 in chips)
Seat 2: Kaptahh (7476 in chips)
Seat 3: Andrew Willian (2661 in chips)
Seat 4: Maks19111979 (3556 in chips)
Seat 5: SuKKinho (6928 in chips)
Seat 6: phpro (2680 in chips)
Seat 7: varen1k322 (5360 in chips)
Seat 8: Cyan Diogenes (8006 in chips)
Zahard23: posts the ante 20
Kaptahh: posts the ante 20
Andrew Willian: posts the ante 20
Maks19111979: posts the ante 20
SuKKinho: posts the ante 20
phpro: posts the ante 20
varen1k322: posts the ante 20
Cyan Diogenes: posts the ante 20
Andrew Willian: posts small blind 75
Maks19111979: posts big blind 150
*** HOLE CARDS ***
Dealt to phpro [7s 2s]
SuKKinho: folds
phpro: folds
varen1k322: raises 150 to 300
Cyan Diogenes: folds
Zahard23: raises 300 to 600
Kaptahh: folds
Andrew Willian: folds
Maks19111979: folds
varen1k322: calls 300
*** FLOP *** [As Jd 7h]
varen1k322: checks
Zahard23: bets 3897 and is all-in
varen1k322: folds
Uncalled bet (3897) returned to Zahard23
Zahard23 collected 1585 from pot
Zahard23: doesn't show hand
bimbas1199 is disconnected
*** SUMMARY ***
Total pot 1585 | Rake 0
Board [As Jd 7h]
Seat 1: Zahard23 collected (1585)
Seat 2: Kaptahh (button) folded before Flop (didn't bet)
Seat 3: Andrew Willian (small blind) folded before Flop
Seat 4: Maks19111979 (big blind) folded before Flop
Seat 5: SuKKinho folded before Flop (didn't bet)
Seat 6: phpro folded before Flop (didn't bet)
Seat 7: varen1k322 folded on the Flop
Seat 8: Cyan Diogenes folded before Flop (didn't bet)


*********** # 25 **************
PokerStars Hand #257046096561: Tournament #3910307458, $0.98+$0.12 USD Hold'em No Limit - Level VIII (75/150) - 2025/07/22 10:36:21 ET
Table '3910307458 12' 9-max Seat #3 is the button
Seat 1: Zahard23 (5482 in chips)
Seat 2: Kaptahh (7456 in chips)
Seat 3: Andrew Willian (2566 in chips)
Seat 4: Maks19111979 (3386 in chips)
Seat 5: SuKKinho (6908 in chips)
Seat 6: phpro (2660 in chips)
Seat 7: varen1k322 (4740 in chips)
Seat 8: Cyan Diogenes (7986 in chips)
Seat 9: bimbas1199 (3000 in chips)
Zahard23: posts the ante 20
Kaptahh: posts the ante 20
Andrew Willian: posts the ante 20
Maks19111979: posts the ante 20
SuKKinho: posts the ante 20
phpro: posts the ante 20
varen1k322: posts the ante 20
Cyan Diogenes: posts the ante 20
bimbas1199: posts the ante 20
Maks19111979: posts small blind 75
SuKKinho: posts big blind 150
*** HOLE CARDS ***
Dealt to phpro [8h Ac]
phpro: folds
varen1k322: folds
Cyan Diogenes: folds
bimbas1199: folds
Zahard23: calls 150
Kaptahh: folds
Andrew Willian: folds
Maks19111979: folds
SuKKinho: checks
*** FLOP *** [9c Kd Jh]
SuKKinho: checks
Zahard23: bets 300
SuKKinho: folds
Uncalled bet (300) returned to Zahard23
Zahard23 collected 555 from pot
Zahard23: doesn't show hand
*** SUMMARY ***
Total pot 555 | Rake 0
Board [9c Kd Jh]
Seat 1: Zahard23 collected (555)
Seat 2: Kaptahh folded before Flop (didn't bet)
Seat 3: Andrew Willian (button) folded before Flop (didn't bet)
Seat 4: Maks19111979 (small blind) folded before Flop
Seat 5: SuKKinho (big blind) folded on the Flop
Seat 6: phpro folded before Flop (didn't bet)
Seat 7: varen1k322 folded before Flop (didn't bet)
Seat 8: Cyan Diogenes folded before Flop (didn't bet)
Seat 9: bimbas1199 folded before Flop (didn't bet)


*********** # 26 **************
PokerStars Hand #257046105639: Tournament #3910307458, $0.98+$0.12 USD Hold'em No Limit - Level VIII (75/150) - 2025/07/22 10:37:19 ET
Table '3910307458 12' 9-max Seat #4 is the button
Seat 1: Zahard23 (5867 in chips)
Seat 2: Kaptahh (7436 in chips)
Seat 3: Andrew Willian (2546 in chips)
Seat 4: Maks19111979 (3291 in chips)
Seat 5: SuKKinho (6738 in chips)
Seat 6: phpro (2640 in chips)
Seat 7: varen1k322 (4720 in chips)
Seat 8: Cyan Diogenes (7966 in chips)
Seat 9: bimbas1199 (2980 in chips)
Zahard23: posts the ante 20
Kaptahh: posts the ante 20
Andrew Willian: posts the ante 20
Maks19111979: posts the ante 20
SuKKinho: posts the ante 20
phpro: posts the ante 20
varen1k322: posts the ante 20
Cyan Diogenes: posts the ante 20
bimbas1199: posts the ante 20
SuKKinho: posts small blind 75
phpro: posts big blind 150
*** HOLE CARDS ***
Dealt to phpro [5s 7h]
varen1k322: folds
Cyan Diogenes: folds
bimbas1199: folds
Zahard23: raises 300 to 450
Kaptahh: folds
Andrew Willian: folds
Maks19111979: folds
SuKKinho: folds
phpro: folds
Uncalled bet (300) returned to Zahard23
Zahard23 collected 555 from pot
Zahard23: doesn't show hand
*** SUMMARY ***
Total pot 555 | Rake 0
Seat 1: Zahard23 collected (555)
Seat 2: Kaptahh folded before Flop (didn't bet)
Seat 3: Andrew Willian folded before Flop (didn't bet)
Seat 4: Maks19111979 (button) folded before Flop (didn't bet)
Seat 5: SuKKinho (small blind) folded before Flop
Seat 6: phpro (big blind) folded before Flop
Seat 7: varen1k322 folded before Flop (didn't bet)
Seat 8: Cyan Diogenes folded before Flop (didn't bet)
Seat 9: bimbas1199 folded before Flop (didn't bet)


*********** # 27 **************
PokerStars Hand #257046110112: Tournament #3910307458, $0.98+$0.12 USD Hold'em No Limit - Level VIII (75/150) - 2025/07/22 10:37:48 ET
Table '3910307458 12' 9-max Seat #5 is the button
Seat 1: Zahard23 (6252 in chips)
Seat 2: Kaptahh (7416 in chips)
Seat 3: Andrew Willian (2526 in chips)
Seat 4: Maks19111979 (3271 in chips)
Seat 5: SuKKinho (6643 in chips)
Seat 6: phpro (2470 in chips)
Seat 7: varen1k322 (4700 in chips)
Seat 8: Cyan Diogenes (7946 in chips)
Seat 9: bimbas1199 (2960 in chips)
Zahard23: posts the ante 20
Kaptahh: posts the ante 20
Andrew Willian: posts the ante 20
Maks19111979: posts the ante 20
SuKKinho: posts the ante 20
phpro: posts the ante 20
varen1k322: posts the ante 20
Cyan Diogenes: posts the ante 20
bimbas1199: posts the ante 20
phpro: posts small blind 75
varen1k322: posts big blind 150
*** HOLE CARDS ***
Dealt to phpro [9c 4d]
Cyan Diogenes: folds
bimbas1199: folds
Zahard23: raises 300 to 450
Kaptahh: folds
Andrew Willian: folds
Maks19111979: folds
SuKKinho: folds
phpro: folds
varen1k322: calls 300
*** FLOP *** [4h 8c 7s]
varen1k322: checks
Zahard23: checks
*** TURN *** [4h 8c 7s] [As]
varen1k322: checks
Zahard23: bets 300
varen1k322: calls 300
*** RIVER *** [4h 8c 7s As] [3h]
varen1k322: bets 439
Zahard23: folds
Uncalled bet (439) returned to varen1k322
varen1k322 collected 1755 from pot
*** SUMMARY ***
Total pot 1755 | Rake 0
Board [4h 8c 7s As 3h]
Seat 1: Zahard23 folded on the River
Seat 2: Kaptahh folded before Flop (didn't bet)
Seat 3: Andrew Willian folded before Flop (didn't bet)
Seat 4: Maks19111979 folded before Flop (didn't bet)
Seat 5: SuKKinho (button) folded before Flop (didn't bet)
Seat 6: phpro (small blind) folded before Flop
Seat 7: varen1k322 (big blind) collected (1755)
Seat 8: Cyan Diogenes folded before Flop (didn't bet)
Seat 9: bimbas1199 folded before Flop (didn't bet)


*********** # 28 **************
PokerStars Hand #257046118426: Tournament #3910307458, $0.98+$0.12 USD Hold'em No Limit - Level VIII (75/150) - 2025/07/22 10:38:42 ET
Table '3910307458 12' 9-max Seat #6 is the button
Seat 1: Zahard23 (5482 in chips)
Seat 2: Kaptahh (7396 in chips)
Seat 3: Andrew Willian (2506 in chips)
Seat 4: Maks19111979 (3251 in chips)
Seat 5: SuKKinho (6623 in chips)
Seat 6: phpro (2375 in chips)
Seat 7: varen1k322 (5685 in chips)
Seat 8: Cyan Diogenes (7926 in chips)
Seat 9: bimbas1199 (2940 in chips)
Zahard23: posts the ante 20
Kaptahh: posts the ante 20
Andrew Willian: posts the ante 20
Maks19111979: posts the ante 20
SuKKinho: posts the ante 20
phpro: posts the ante 20
varen1k322: posts the ante 20
Cyan Diogenes: posts the ante 20
bimbas1199: posts the ante 20
varen1k322: posts small blind 75
Cyan Diogenes: posts big blind 150
*** HOLE CARDS ***
Dealt to phpro [Jh 6d]
bimbas1199: folds
Zahard23: folds
Kaptahh: folds
Andrew Willian: folds
Maks19111979: raises 150 to 300
SuKKinho: folds
phpro: folds
varen1k322: folds
Cyan Diogenes: calls 150
*** FLOP *** [9d 4c 4h]
Cyan Diogenes: checks
Maks19111979: checks
*** TURN *** [9d 4c 4h] [Jc]
Cyan Diogenes: bets 450
Maks19111979: calls 450
*** RIVER *** [9d 4c 4h Jc] [Ac]
Cyan Diogenes: checks
Maks19111979: bets 1351
Cyan Diogenes: calls 1351
*** SHOW DOWN ***
Maks19111979: shows [Kd Tc] (a pair of Fours)
Cyan Diogenes: shows [8d As] (two pair, Aces and Fours)
Cyan Diogenes collected 4457 from pot
*** SUMMARY ***
Total pot 4457 | Rake 0
Board [9d 4c 4h Jc Ac]
Seat 1: Zahard23 folded before Flop (didn't bet)
Seat 2: Kaptahh folded before Flop (didn't bet)
Seat 3: Andrew Willian folded before Flop (didn't bet)
Seat 4: Maks19111979 showed [Kd Tc] and lost with a pair of Fours
Seat 5: SuKKinho folded before Flop (didn't bet)
Seat 6: phpro (button) folded before Flop (didn't bet)
Seat 7: varen1k322 (small blind) folded before Flop
Seat 8: Cyan Diogenes (big blind) showed [8d As] and won (4457) with two pair, Aces and Fours
Seat 9: bimbas1199 folded before Flop (didn't bet)


*********** # 29 **************
PokerStars Hand #257046129434: Tournament #3910307458, $0.98+$0.12 USD Hold'em No Limit - Level VIII (75/150) - 2025/07/22 10:39:53 ET
Table '3910307458 12' 9-max Seat #7 is the button
Seat 1: Zahard23 (5462 in chips)
Seat 2: Kaptahh (7376 in chips)
Seat 3: Andrew Willian (2486 in chips)
Seat 4: Maks19111979 (1130 in chips)
Seat 5: SuKKinho (6603 in chips)
Seat 6: phpro (2355 in chips)
Seat 7: varen1k322 (5590 in chips)
Seat 8: Cyan Diogenes (10262 in chips)
Seat 9: bimbas1199 (2920 in chips)
Zahard23: posts the ante 20
Kaptahh: posts the ante 20
Andrew Willian: posts the ante 20
Maks19111979: posts the ante 20
SuKKinho: posts the ante 20
phpro: posts the ante 20
varen1k322: posts the ante 20
Cyan Diogenes: posts the ante 20
bimbas1199: posts the ante 20
Cyan Diogenes: posts small blind 75
bimbas1199: posts big blind 150
*** HOLE CARDS ***
Dealt to phpro [5c 2s]
Zahard23: raises 150 to 300
Kaptahh: folds
Andrew Willian: folds
Maks19111979: folds
SuKKinho: folds
phpro: folds
varen1k322: folds
Cyan Diogenes: folds
bimbas1199: calls 150
*** FLOP *** [Ah 7h Qc]
bimbas1199: checks
Zahard23: bets 450
bimbas1199: folds
Uncalled bet (450) returned to Zahard23
Zahard23 collected 855 from pot
Zahard23: doesn't show hand
*** SUMMARY ***
Total pot 855 | Rake 0
Board [Ah 7h Qc]
Seat 1: Zahard23 collected (855)
Seat 2: Kaptahh folded before Flop (didn't bet)
Seat 3: Andrew Willian folded before Flop (didn't bet)
Seat 4: Maks19111979 folded before Flop (didn't bet)
Seat 5: SuKKinho folded before Flop (didn't bet)
Seat 6: phpro folded before Flop (didn't bet)
Seat 7: varen1k322 (button) folded before Flop (didn't bet)
Seat 8: Cyan Diogenes (small blind) folded before Flop
Seat 9: bimbas1199 (big blind) folded on the Flop


*********** # 30 **************
PokerStars Hand #257046134164: Tournament #3910307458, $0.98+$0.12 USD Hold'em No Limit - Level VIII (75/150) - 2025/07/22 10:40:23 ET
Table '3910307458 12' 9-max Seat #8 is the button
Seat 1: Zahard23 (5997 in chips)
Seat 2: Kaptahh (7356 in chips)
Seat 3: Andrew Willian (2466 in chips)
Seat 4: Maks19111979 (1110 in chips)
Seat 5: SuKKinho (6583 in chips)
Seat 6: phpro (2335 in chips)
Seat 7: varen1k322 (5570 in chips)
Seat 8: Cyan Diogenes (10167 in chips)
Seat 9: bimbas1199 (2600 in chips)
Zahard23: posts the ante 20
Kaptahh: posts the ante 20
Andrew Willian: posts the ante 20
Maks19111979: posts the ante 20
SuKKinho: posts the ante 20
phpro: posts the ante 20
varen1k322: posts the ante 20
Cyan Diogenes: posts the ante 20
bimbas1199: posts the ante 20
bimbas1199: posts small blind 75
Zahard23: posts big blind 150
*** HOLE CARDS ***
Dealt to phpro [9c As]
Kaptahh: folds
Andrew Willian: folds
Maks19111979: folds
SuKKinho: folds
phpro: folds
varen1k322: folds
Cyan Diogenes: folds
bimbas1199: raises 225 to 375
Zahard23: folds
Uncalled bet (225) returned to bimbas1199
bimbas1199 collected 480 from pot
bimbas1199: doesn't show hand
*** SUMMARY ***
Total pot 480 | Rake 0
Seat 1: Zahard23 (big blind) folded before Flop
Seat 2: Kaptahh folded before Flop (didn't bet)
Seat 3: Andrew Willian folded before Flop (didn't bet)
Seat 4: Maks19111979 folded before Flop (didn't bet)
Seat 5: SuKKinho folded before Flop (didn't bet)
Seat 6: phpro folded before Flop (didn't bet)
Seat 7: varen1k322 folded before Flop (didn't bet)
Seat 8: Cyan Diogenes (button) folded before Flop (didn't bet)
Seat 9: bimbas1199 (small blind) collected (480)


*********** # 31 **************
PokerStars Hand #257046139606: Tournament #3910307458, $0.98+$0.12 USD Hold'em No Limit - Level VIII (75/150) - 2025/07/22 10:40:58 ET
Table '3910307458 12' 9-max Seat #9 is the button
Seat 1: Zahard23 (5827 in chips)
Seat 3: Andrew Willian (2446 in chips)
Seat 4: Maks19111979 (1090 in chips)
Seat 5: SuKKinho (6563 in chips)
Seat 6: phpro (2315 in chips)
Seat 7: varen1k322 (5550 in chips)
Seat 8: Cyan Diogenes (10147 in chips)
Seat 9: bimbas1199 (2910 in chips)
Zahard23: posts the ante 20
Andrew Willian: posts the ante 20
Maks19111979: posts the ante 20
SuKKinho: posts the ante 20
phpro: posts the ante 20
varen1k322: posts the ante 20
Cyan Diogenes: posts the ante 20
bimbas1199: posts the ante 20
Zahard23: posts small blind 75
Andrew Willian: posts big blind 150
*** HOLE CARDS ***
Dealt to phpro [3h 8s]
Maks19111979: folds
SuKKinho: folds
phpro: folds
varen1k322: folds
Cyan Diogenes: folds
bimbas1199: raises 150 to 300
Zahard23: raises 300 to 600
Andrew Willian: folds
bimbas1199: raises 2290 to 2890 and is all-in
Zahard23: calls 2290
*** FLOP *** [2h 5s 8d]
*** TURN *** [2h 5s 8d] [4s]
*** RIVER *** [2h 5s 8d 4s] [4c]
*** SHOW DOWN ***
Zahard23: shows [As Kd] (a pair of Fours)
bimbas1199: shows [4d Ah] (three of a kind, Fours)
bimbas1199 collected 6090 from pot
*** SUMMARY ***
Total pot 6090 | Rake 0
Board [2h 5s 8d 4s 4c]
Seat 1: Zahard23 (small blind) showed [As Kd] and lost with a pair of Fours
Seat 3: Andrew Willian (big blind) folded before Flop
Seat 4: Maks19111979 folded before Flop (didn't bet)
Seat 5: SuKKinho folded before Flop (didn't bet)
Seat 6: phpro folded before Flop (didn't bet)
Seat 7: varen1k322 folded before Flop (didn't bet)
Seat 8: Cyan Diogenes folded before Flop (didn't bet)
Seat 9: bimbas1199 (button) showed [4d Ah] and won (6090) with three of a kind, Fours


*********** # 32 **************
PokerStars Hand #257046146112: Tournament #3910307458, $0.98+$0.12 USD Hold'em No Limit - Level VIII (75/150) - 2025/07/22 10:41:40 ET
Table '3910307458 12' 9-max Seat #1 is the button
Seat 1: Zahard23 (2917 in chips)
Seat 3: Andrew Willian (2276 in chips)
Seat 4: Maks19111979 (1070 in chips)
Seat 5: SuKKinho (6543 in chips)
Seat 6: phpro (2295 in chips)
Seat 7: varen1k322 (5530 in chips)
Seat 8: Cyan Diogenes (10127 in chips)
Seat 9: bimbas1199 (6090 in chips)
Zahard23: posts the ante 20
Andrew Willian: posts the ante 20
Maks19111979: posts the ante 20
SuKKinho: posts the ante 20
phpro: posts the ante 20
varen1k322: posts the ante 20
Cyan Diogenes: posts the ante 20
bimbas1199: posts the ante 20
Andrew Willian: posts small blind 75
Maks19111979: posts big blind 150
*** HOLE CARDS ***
Dealt to phpro [Tc 6h]
SuKKinho: folds
phpro: folds
varen1k322: folds
Cyan Diogenes: folds
bimbas1199 is connected
bimbas1199: folds
Zahard23: calls 150
Andrew Willian: raises 2106 to 2256 and is all-in
Maks19111979: calls 900 and is all-in
Zahard23: calls 2106
*** FLOP *** [5d 2h Js]
*** TURN *** [5d 2h Js] [Ac]
*** RIVER *** [5d 2h Js Ac] [Jd]
*** SHOW DOWN ***
Andrew Willian: shows [Ah 7d] (two pair, Aces and Jacks)
Zahard23: shows [Ad 2d] (two pair, Aces and Jacks - lower kicker)
Andrew Willian collected 2412 from side pot
Maks19111979: shows [4d 4s] (two pair, Jacks and Fours)
Andrew Willian collected 3310 from main pot
Maks19111979 finished the tournament in 171st place
*** SUMMARY ***
Total pot 5722 Main pot 3310. Side pot 2412. | Rake 0
Board [5d 2h Js Ac Jd]
Seat 1: Zahard23 (button) showed [Ad 2d] and lost with two pair, Aces and Jacks
Seat 3: Andrew Willian (small blind) showed [Ah 7d] and won (5722) with two pair, Aces and Jacks
Seat 4: Maks19111979 (big blind) showed [4d 4s] and lost with two pair, Jacks and Fours
Seat 5: SuKKinho folded before Flop (didn't bet)
Seat 6: phpro folded before Flop (didn't bet)
Seat 7: varen1k322 folded before Flop (didn't bet)
Seat 8: Cyan Diogenes folded before Flop (didn't bet)
Seat 9: bimbas1199 folded before Flop (didn't bet)


*********** # 33 **************
PokerStars Hand #257046155253: Tournament #3910307458, $0.98+$0.12 USD Hold'em No Limit - Level IX (100/200) - 2025/07/22 10:42:39 ET
Table '3910307458 12' 9-max Seat #3 is the button
Seat 1: Zahard23 (641 in chips)
Seat 2: hesoma_89 (8260 in chips)
Seat 3: Andrew Willian (5722 in chips)
Seat 5: SuKKinho (6523 in chips)
Seat 6: phpro (2275 in chips)
Seat 7: varen1k322 (5510 in chips)
Seat 8: Cyan Diogenes (10107 in chips)
Seat 9: bimbas1199 (6070 in chips)
Zahard23: posts the ante 25
hesoma_89: posts the ante 25
Andrew Willian: posts the ante 25
SuKKinho: posts the ante 25
phpro: posts the ante 25
varen1k322: posts the ante 25
Cyan Diogenes: posts the ante 25
bimbas1199: posts the ante 25
SuKKinho: posts small blind 100
phpro: posts big blind 200
*** HOLE CARDS ***
Dealt to phpro [Th Qd]
varen1k322: folds
Cyan Diogenes: folds
bimbas1199: folds
Zahard23: folds
hesoma_89: folds
Andrew Willian: raises 200 to 400
SuKKinho: folds
phpro: calls 200
*** FLOP *** [4s Jd 3c]
phpro: checks
Andrew Willian: bets 363
phpro: folds
Uncalled bet (363) returned to Andrew Willian
Andrew Willian collected 1100 from pot
*** SUMMARY ***
Total pot 1100 | Rake 0
Board [4s Jd 3c]
Seat 1: Zahard23 folded before Flop (didn't bet)
Seat 2: hesoma_89 folded before Flop (didn't bet)
Seat 3: Andrew Willian (button) collected (1100)
Seat 5: SuKKinho (small blind) folded before Flop
Seat 6: phpro (big blind) folded on the Flop
Seat 7: varen1k322 folded before Flop (didn't bet)
Seat 8: Cyan Diogenes folded before Flop (didn't bet)
Seat 9: bimbas1199 folded before Flop (didn't bet)


*********** # 34 **************
PokerStars Hand #257046163153: Tournament #3910307458, $0.98+$0.12 USD Hold'em No Limit - Level IX (100/200) - 2025/07/22 10:43:30 ET
Table '3910307458 12' 9-max Seat #5 is the button
Seat 1: Zahard23 (616 in chips)
Seat 2: hesoma_89 (8235 in chips)
Seat 3: Andrew Willian (6397 in chips)
Seat 5: SuKKinho (6398 in chips)
Seat 6: phpro (1850 in chips)
Seat 7: varen1k322 (5485 in chips)
Seat 8: Cyan Diogenes (10082 in chips)
Seat 9: bimbas1199 (6045 in chips)
Zahard23: posts the ante 25
hesoma_89: posts the ante 25
Andrew Willian: posts the ante 25
SuKKinho: posts the ante 25
phpro: posts the ante 25
varen1k322: posts the ante 25
Cyan Diogenes: posts the ante 25
bimbas1199: posts the ante 25
phpro: posts small blind 100
varen1k322: posts big blind 200
*** HOLE CARDS ***
Dealt to phpro [Qc 6c]
Cyan Diogenes has timed out
Cyan Diogenes: folds
Cyan Diogenes is sitting out
bimbas1199: folds
Zahard23: folds
hesoma_89: folds
Andrew Willian: folds
SuKKinho: folds
Cyan Diogenes has returned
phpro: raises 200 to 400
varen1k322: calls 200
*** FLOP *** [Kc 9d Ah]
phpro: bets 330
varen1k322: folds
Uncalled bet (330) returned to phpro
phpro collected 1000 from pot
phpro: doesn't show hand
*** SUMMARY ***
Total pot 1000 | Rake 0
Board [Kc 9d Ah]
Seat 1: Zahard23 folded before Flop (didn't bet)
Seat 2: hesoma_89 folded before Flop (didn't bet)
Seat 3: Andrew Willian folded before Flop (didn't bet)
Seat 5: SuKKinho (button) folded before Flop (didn't bet)
Seat 6: phpro (small blind) collected (1000)
Seat 7: varen1k322 (big blind) folded on the Flop
Seat 8: Cyan Diogenes folded before Flop (didn't bet)
Seat 9: bimbas1199 folded before Flop (didn't bet)


*********** # 35 **************
PokerStars Hand #257046173480: Tournament #3910307458, $0.98+$0.12 USD Hold'em No Limit - Level IX (100/200) - 2025/07/22 10:44:36 ET
Table '3910307458 12' 9-max Seat #6 is the button
Seat 1: Zahard23 (591 in chips)
Seat 2: hesoma_89 (8210 in chips)
Seat 3: Andrew Willian (6372 in chips)
Seat 5: SuKKinho (6373 in chips)
Seat 6: phpro (2425 in chips)
Seat 7: varen1k322 (5060 in chips)
Seat 8: Cyan Diogenes (10057 in chips)
Seat 9: bimbas1199 (6020 in chips)
Zahard23: posts the ante 25
hesoma_89: posts the ante 25
Andrew Willian: posts the ante 25
SuKKinho: posts the ante 25
phpro: posts the ante 25
varen1k322: posts the ante 25
Cyan Diogenes: posts the ante 25
bimbas1199: posts the ante 25
varen1k322: posts small blind 100
Cyan Diogenes: posts big blind 200
*** HOLE CARDS ***
Dealt to phpro [8c 2d]
bimbas1199: folds
Zahard23: folds
hesoma_89: folds
Andrew Willian: raises 200 to 400
SuKKinho: folds
phpro: folds
varen1k322: folds
Cyan Diogenes has timed out
Cyan Diogenes: folds
Cyan Diogenes is sitting out
Uncalled bet (200) returned to Andrew Willian
Andrew Willian collected 700 from pot
*** SUMMARY ***
Total pot 700 | Rake 0
Seat 1: Zahard23 folded before Flop (didn't bet)
Seat 2: hesoma_89 folded before Flop (didn't bet)
Seat 3: Andrew Willian collected (700)
Seat 5: SuKKinho folded before Flop (didn't bet)
Seat 6: phpro (button) folded before Flop (didn't bet)
Seat 7: varen1k322 (small blind) folded before Flop
Seat 8: Cyan Diogenes (big blind) folded before Flop
Seat 9: bimbas1199 folded before Flop (didn't bet)


*********** # 36 **************
PokerStars Hand #257046180856: Tournament #3910307458, $0.98+$0.12 USD Hold'em No Limit - Level IX (100/200) - 2025/07/22 10:45:22 ET
Table '3910307458 12' 9-max Seat #7 is the button
Seat 1: Zahard23 (566 in chips)
Seat 2: hesoma_89 (8185 in chips)
Seat 3: Andrew Willian (6847 in chips)
Seat 4: Isr0il (3000 in chips)
Seat 5: SuKKinho (6348 in chips)
Seat 6: phpro (2400 in chips)
Seat 7: varen1k322 (4935 in chips)
Seat 8: Cyan Diogenes (9832 in chips) is sitting out
Seat 9: bimbas1199 (5995 in chips)
Zahard23: posts the ante 25
hesoma_89: posts the ante 25
Andrew Willian: posts the ante 25
Isr0il: posts the ante 25
SuKKinho: posts the ante 25
phpro: posts the ante 25
varen1k322: posts the ante 25
Cyan Diogenes: posts the ante 25
bimbas1199: posts the ante 25
Cyan Diogenes: posts small blind 100
bimbas1199: posts big blind 200
*** HOLE CARDS ***
Dealt to phpro [5d 4s]
Zahard23: raises 341 to 541 and is all-in
hesoma_89: folds
Andrew Willian: folds
Isr0il: calls 541
SuKKinho: folds
phpro: folds
varen1k322: folds
Cyan Diogenes: folds
bimbas1199: folds
*** FLOP *** [2h 2s 2c]
*** TURN *** [2h 2s 2c] [As]
*** RIVER *** [2h 2s 2c As] [4d]
Cyan Diogenes has returned
*** SHOW DOWN ***
Zahard23: shows [5c Ac] (a full house, Deuces full of Aces)
Isr0il: shows [Qs Jh] (three of a kind, Deuces)
Zahard23 collected 1607 from pot
*** SUMMARY ***
Total pot 1607 | Rake 0
Board [2h 2s 2c As 4d]
Seat 1: Zahard23 showed [5c Ac] and won (1607) with a full house, Deuces full of Aces
Seat 2: hesoma_89 folded before Flop (didn't bet)
Seat 3: Andrew Willian folded before Flop (didn't bet)
Seat 4: Isr0il showed [Qs Jh] and lost with three of a kind, Deuces
Seat 5: SuKKinho folded before Flop (didn't bet)
Seat 6: phpro folded before Flop (didn't bet)
Seat 7: varen1k322 (button) folded before Flop (didn't bet)
Seat 8: Cyan Diogenes (small blind) folded before Flop
Seat 9: bimbas1199 (big blind) folded before Flop


*********** # 37 **************
PokerStars Hand #257046184801: Tournament #3910307458, $0.98+$0.12 USD Hold'em No Limit - Level IX (100/200) - 2025/07/22 10:45:47 ET
Table '3910307458 12' 9-max Seat #8 is the button
Seat 1: Zahard23 (1607 in chips)
Seat 2: hesoma_89 (8160 in chips)
Seat 3: Andrew Willian (6822 in chips)
Seat 4: Isr0il (2434 in chips)
Seat 5: SuKKinho (6323 in chips)
Seat 6: phpro (2375 in chips)
Seat 7: varen1k322 (4910 in chips)
Seat 8: Cyan Diogenes (9707 in chips)
Seat 9: bimbas1199 (5770 in chips)
Zahard23: posts the ante 25
hesoma_89: posts the ante 25
Andrew Willian: posts the ante 25
Isr0il: posts the ante 25
SuKKinho: posts the ante 25
phpro: posts the ante 25
varen1k322: posts the ante 25
Cyan Diogenes: posts the ante 25
bimbas1199: posts the ante 25
bimbas1199: posts small blind 100
Zahard23: posts big blind 200
*** HOLE CARDS ***
Dealt to phpro [2d 8c]
hesoma_89: raises 200 to 400
Andrew Willian: folds
Isr0il: folds
Cyan Diogenes is disconnected
SuKKinho: folds
phpro: folds
varen1k322: folds
Cyan Diogenes has timed out while disconnected
Cyan Diogenes: folds
Cyan Diogenes is sitting out
bimbas1199: folds
Zahard23: calls 200
*** FLOP *** [Ac Jc 5c]
Zahard23: checks
hesoma_89: bets 371
Zahard23: calls 371
*** TURN *** [Ac Jc 5c] [3s]
Zahard23: checks
hesoma_89: bets 1344
Zahard23: calls 811 and is all-in
Uncalled bet (533) returned to hesoma_89
*** RIVER *** [Ac Jc 5c 3s] [6c]
*** SHOW DOWN ***
Zahard23: shows [8d Kc] (a flush, Ace high)
hesoma_89: shows [Jh Js] (three of a kind, Jacks)
Zahard23 collected 3489 from pot
*** SUMMARY ***
Total pot 3489 | Rake 0
Board [Ac Jc 5c 3s 6c]
Seat 1: Zahard23 (big blind) showed [8d Kc] and won (3489) with a flush, Ace high
Seat 2: hesoma_89 showed [Jh Js] and lost with three of a kind, Jacks
Seat 3: Andrew Willian folded before Flop (didn't bet)
Seat 4: Isr0il folded before Flop (didn't bet)
Seat 5: SuKKinho folded before Flop (didn't bet)
Seat 6: phpro folded before Flop (didn't bet)
Seat 7: varen1k322 folded before Flop (didn't bet)
Seat 8: Cyan Diogenes (button) folded before Flop (didn't bet)
Seat 9: bimbas1199 (small blind) folded before Flop


*********** # 38 **************
PokerStars Hand #257046195519: Tournament #3910307458, $0.98+$0.12 USD Hold'em No Limit - Level IX (100/200) - 2025/07/22 10:46:54 ET
Table '3910307458 12' 9-max Seat #9 is the button
Seat 1: Zahard23 (3489 in chips)
Seat 2: hesoma_89 (6553 in chips)
Seat 3: Andrew Willian (6797 in chips)
Seat 4: Isr0il (2409 in chips)
Seat 5: SuKKinho (6298 in chips)
Seat 6: phpro (2350 in chips)
Seat 7: varen1k322 (4885 in chips)
Seat 8: Cyan Diogenes (9682 in chips) is sitting out
Seat 9: bimbas1199 (5645 in chips)
Zahard23: posts the ante 25
hesoma_89: posts the ante 25
Andrew Willian: posts the ante 25
Isr0il: posts the ante 25
SuKKinho: posts the ante 25
phpro: posts the ante 25
varen1k322: posts the ante 25
Cyan Diogenes: posts the ante 25
bimbas1199: posts the ante 25
Zahard23: posts small blind 100
hesoma_89: posts big blind 200
*** HOLE CARDS ***
Dealt to phpro [3d 6c]
Andrew Willian: folds
Isr0il: folds
SuKKinho: raises 200 to 400
phpro: folds
varen1k322: folds
Cyan Diogenes: folds
Cyan Diogenes is disconnected
Cyan Diogenes has returned
bimbas1199: folds
Zahard23: raises 400 to 800
hesoma_89: folds
SuKKinho: raises 900 to 1700
Zahard23: raises 1764 to 3464 and is all-in
SuKKinho: calls 1764
*** FLOP *** [Th 4s 5d]
*** TURN *** [Th 4s 5d] [Js]
*** RIVER *** [Th 4s 5d Js] [Ts]
*** SHOW DOWN ***
Zahard23: shows [Ad Kc] (a pair of Tens)
SuKKinho: shows [Ac Ah] (two pair, Aces and Tens)
SuKKinho collected 7353 from pot
Zahard23 finished the tournament in 160th place
*** SUMMARY ***
Total pot 7353 | Rake 0
Board [Th 4s 5d Js Ts]
Seat 1: Zahard23 (small blind) showed [Ad Kc] and lost with a pair of Tens
Seat 2: hesoma_89 (big blind) folded before Flop
Seat 3: Andrew Willian folded before Flop (didn't bet)
Seat 4: Isr0il folded before Flop (didn't bet)
Seat 5: SuKKinho showed [Ac Ah] and won (7353) with two pair, Aces and Tens
Seat 6: phpro folded before Flop (didn't bet)
Seat 7: varen1k322 folded before Flop (didn't bet)
Seat 8: Cyan Diogenes folded before Flop (didn't bet)
Seat 9: bimbas1199 (button) folded before Flop (didn't bet)


*********** # 39 **************
PokerStars Hand #257046204578: Tournament #3910307458, $0.98+$0.12 USD Hold'em No Limit - Level IX (100/200) - 2025/07/22 10:47:52 ET
Table '3910307458 12' 9-max Seat #2 is the button
Seat 2: hesoma_89 (6328 in chips)
Seat 3: Andrew Willian (6772 in chips)
Seat 4: Isr0il (2384 in chips)
Seat 5: SuKKinho (10162 in chips)
Seat 6: phpro (2325 in chips)
Seat 7: varen1k322 (4860 in chips)
Seat 8: Cyan Diogenes (9657 in chips)
Seat 9: bimbas1199 (5620 in chips)
hesoma_89: posts the ante 25
Andrew Willian: posts the ante 25
Isr0il: posts the ante 25
SuKKinho: posts the ante 25
phpro: posts the ante 25
varen1k322: posts the ante 25
Cyan Diogenes: posts the ante 25
bimbas1199: posts the ante 25
Andrew Willian: posts small blind 100
Isr0il: posts big blind 200
*** HOLE CARDS ***
Dealt to phpro [5s Qh]
SuKKinho: raises 300 to 500
phpro: folds
varen1k322: folds
Cyan Diogenes: folds
bimbas1199: calls 500
hesoma_89: folds
Andrew Willian: folds
Isr0il: folds
*** FLOP *** [6c Qd Ts]
SuKKinho: bets 495
bimbas1199: calls 495
*** TURN *** [6c Qd Ts] [2s]
SuKKinho: bets 1320
bimbas1199: folds
Uncalled bet (1320) returned to SuKKinho
SuKKinho collected 2490 from pot
SuKKinho: doesn't show hand
*** SUMMARY ***
Total pot 2490 | Rake 0
Board [6c Qd Ts 2s]
Seat 2: hesoma_89 (button) folded before Flop (didn't bet)
Seat 3: Andrew Willian (small blind) folded before Flop
Seat 4: Isr0il (big blind) folded before Flop
Seat 5: SuKKinho collected (2490)
Seat 6: phpro folded before Flop (didn't bet)
Seat 7: varen1k322 folded before Flop (didn't bet)
Seat 8: Cyan Diogenes folded before Flop (didn't bet)
Seat 9: bimbas1199 folded on the Turn


*********** # 40 **************
PokerStars Hand #257046212197: Tournament #3910307458, $0.98+$0.12 USD Hold'em No Limit - Level IX (100/200) - 2025/07/22 10:48:39 ET
Table '3910307458 12' 9-max Seat #3 is the button
Seat 1: Lu_days (3000 in chips)
Seat 2: hesoma_89 (6303 in chips)
Seat 3: Andrew Willian (6647 in chips)
Seat 4: Isr0il (2159 in chips)
Seat 6: phpro (2300 in chips)
Seat 7: varen1k322 (4835 in chips)
Seat 8: Cyan Diogenes (9632 in chips)
Seat 9: bimbas1199 (4600 in chips)
Lu_days: posts the ante 25
hesoma_89: posts the ante 25
Andrew Willian: posts the ante 25
Isr0il: posts the ante 25
phpro: posts the ante 25
varen1k322: posts the ante 25
Cyan Diogenes: posts the ante 25
bimbas1199: posts the ante 25
Isr0il: posts small blind 100
phpro: posts big blind 200
*** HOLE CARDS ***
Dealt to phpro [9d 5h]
varen1k322: folds
Cyan Diogenes: folds
bimbas1199: folds
Lu_days: calls 200
hesoma_89: folds
Andrew Willian: folds
Isr0il: folds
phpro: checks
*** FLOP *** [7s Ah 8h]
phpro: checks
Lu_days: bets 200
phpro: folds
Uncalled bet (200) returned to Lu_days
Lu_days collected 700 from pot
*** SUMMARY ***
Total pot 700 | Rake 0
Board [7s Ah 8h]
Seat 1: Lu_days collected (700)
Seat 2: hesoma_89 folded before Flop (didn't bet)
Seat 3: Andrew Willian (button) folded before Flop (didn't bet)
Seat 4: Isr0il (small blind) folded before Flop
Seat 6: phpro (big blind) folded on the Flop
Seat 7: varen1k322 folded before Flop (didn't bet)
Seat 8: Cyan Diogenes folded before Flop (didn't bet)
Seat 9: bimbas1199 folded before Flop (didn't bet)


*********** # 41 **************
PokerStars Hand #257046220247: Tournament #3910307458, $0.98+$0.12 USD Hold'em No Limit - Level IX (100/200) - 2025/07/22 10:49:30 ET
Table '3910307458 12' 9-max Seat #4 is the button
Seat 1: Lu_days (3475 in chips)
Seat 2: hesoma_89 (6278 in chips)
Seat 3: Andrew Willian (6622 in chips)
Seat 4: Isr0il (2034 in chips)
Seat 6: phpro (2075 in chips)
Seat 7: varen1k322 (4810 in chips)
Seat 8: Cyan Diogenes (9607 in chips)
Seat 9: bimbas1199 (4575 in chips)
Lu_days: posts the ante 25
hesoma_89: posts the ante 25
Andrew Willian: posts the ante 25
Isr0il: posts the ante 25
phpro: posts the ante 25
varen1k322: posts the ante 25
Cyan Diogenes: posts the ante 25
bimbas1199: posts the ante 25
phpro: posts small blind 100
varen1k322: posts big blind 200
*** HOLE CARDS ***
Dealt to phpro [Ts 2s]
Cyan Diogenes: raises 200 to 400
bimbas1199: folds
Lu_days: folds
boensen1982 is disconnected
hesoma_89: folds
Andrew Willian: folds
Isr0il: folds
phpro: folds
varen1k322: calls 200
*** FLOP *** [4d Qs Kc]
varen1k322: checks
Cyan Diogenes: bets 500
varen1k322: folds
Uncalled bet (500) returned to Cyan Diogenes
Cyan Diogenes collected 1100 from pot
Cyan Diogenes: doesn't show hand
*** SUMMARY ***
Total pot 1100 | Rake 0
Board [4d Qs Kc]
Seat 1: Lu_days folded before Flop (didn't bet)
Seat 2: hesoma_89 folded before Flop (didn't bet)
Seat 3: Andrew Willian folded before Flop (didn't bet)
Seat 4: Isr0il (button) folded before Flop (didn't bet)
Seat 6: phpro (small blind) folded before Flop
Seat 7: varen1k322 (big blind) folded on the Flop
Seat 8: Cyan Diogenes collected (1100)
Seat 9: bimbas1199 folded before Flop (didn't bet)


*********** # 42 **************
PokerStars Hand #257046227529: Tournament #3910307458, $0.98+$0.12 USD Hold'em No Limit - Level IX (100/200) - 2025/07/22 10:50:16 ET
Table '3910307458 12' 9-max Seat #6 is the button
Seat 1: Lu_days (3450 in chips)
Seat 2: hesoma_89 (6253 in chips)
Seat 3: Andrew Willian (6597 in chips)
Seat 4: Isr0il (2009 in chips)
Seat 5: boensen1982 (3000 in chips)
Seat 6: phpro (1950 in chips)
Seat 7: varen1k322 (4385 in chips)
Seat 8: Cyan Diogenes (10282 in chips)
Seat 9: bimbas1199 (4550 in chips)
Lu_days: posts the ante 25
hesoma_89: posts the ante 25
Andrew Willian: posts the ante 25
Isr0il: posts the ante 25
boensen1982: posts the ante 25
phpro: posts the ante 25
varen1k322: posts the ante 25
Cyan Diogenes: posts the ante 25
bimbas1199: posts the ante 25
varen1k322: posts small blind 100
Cyan Diogenes: posts big blind 200
*** HOLE CARDS ***
Dealt to phpro [Qs 2h]
bimbas1199: raises 200 to 400
Lu_days: folds
hesoma_89: folds
Andrew Willian: folds
Isr0il: folds
boensen1982: folds
phpro: folds
varen1k322: folds
Cyan Diogenes: folds
Uncalled bet (200) returned to bimbas1199
bimbas1199 collected 725 from pot
bimbas1199: doesn't show hand
*** SUMMARY ***
Total pot 725 | Rake 0
Seat 1: Lu_days folded before Flop (didn't bet)
Seat 2: hesoma_89 folded before Flop (didn't bet)
Seat 3: Andrew Willian folded before Flop (didn't bet)
Seat 4: Isr0il folded before Flop (didn't bet)
Seat 5: boensen1982 folded before Flop (didn't bet)
Seat 6: phpro (button) folded before Flop (didn't bet)
Seat 7: varen1k322 (small blind) folded before Flop
Seat 8: Cyan Diogenes (big blind) folded before Flop
Seat 9: bimbas1199 collected (725)


*********** # 43 **************
PokerStars Hand #257046233165: Tournament #3910307458, $0.98+$0.12 USD Hold'em No Limit - Level IX (100/200) - 2025/07/22 10:50:51 ET
Table '3910307458 12' 9-max Seat #7 is the button
Seat 1: Lu_days (3425 in chips)
Seat 2: hesoma_89 (6228 in chips)
Seat 3: Andrew Willian (6572 in chips)
Seat 4: Isr0il (1984 in chips)
Seat 5: boensen1982 (2975 in chips)
Seat 6: phpro (1925 in chips)
Seat 7: varen1k322 (4260 in chips)
Seat 8: Cyan Diogenes (10057 in chips)
Seat 9: bimbas1199 (5050 in chips)
Lu_days: posts the ante 25
hesoma_89: posts the ante 25
Andrew Willian: posts the ante 25
Isr0il: posts the ante 25
boensen1982: posts the ante 25
phpro: posts the ante 25
varen1k322: posts the ante 25
Cyan Diogenes: posts the ante 25
bimbas1199: posts the ante 25
Cyan Diogenes: posts small blind 100
bimbas1199: posts big blind 200
*** HOLE CARDS ***
Dealt to phpro [Qs Jh]
Lu_days: folds
hesoma_89: folds
Andrew Willian: raises 200 to 400
Isr0il: folds
boensen1982: raises 2550 to 2950 and is all-in
phpro: folds
varen1k322: folds
Cyan Diogenes: folds
bimbas1199: folds
Andrew Willian: folds
Uncalled bet (2550) returned to boensen1982
boensen1982 collected 1325 from pot
boensen1982: doesn't show hand
*** SUMMARY ***
Total pot 1325 | Rake 0
Seat 1: Lu_days folded before Flop (didn't bet)
Seat 2: hesoma_89 folded before Flop (didn't bet)
Seat 3: Andrew Willian folded before Flop
Seat 4: Isr0il folded before Flop (didn't bet)
Seat 5: boensen1982 collected (1325)
Seat 6: phpro folded before Flop (didn't bet)
Seat 7: varen1k322 (button) folded before Flop (didn't bet)
Seat 8: Cyan Diogenes (small blind) folded before Flop
Seat 9: bimbas1199 (big blind) folded before Flop


*********** # 44 **************
PokerStars Hand #257046240546: Tournament #3910307458, $0.98+$0.12 USD Hold'em No Limit - Level IX (100/200) - 2025/07/22 10:51:38 ET
Table '3910307458 12' 9-max Seat #8 is the button
Seat 1: Lu_days (3400 in chips)
Seat 2: hesoma_89 (6203 in chips)
Seat 3: Andrew Willian (6147 in chips)
Seat 4: Isr0il (1959 in chips)
Seat 5: boensen1982 (3875 in chips)
Seat 6: phpro (1900 in chips)
Seat 7: varen1k322 (4235 in chips)
Seat 8: Cyan Diogenes (9932 in chips)
Seat 9: bimbas1199 (4825 in chips)
Lu_days: posts the ante 25
hesoma_89: posts the ante 25
Andrew Willian: posts the ante 25
Isr0il: posts the ante 25
boensen1982: posts the ante 25
phpro: posts the ante 25
varen1k322: posts the ante 25
Cyan Diogenes: posts the ante 25
bimbas1199: posts the ante 25
bimbas1199: posts small blind 100
Lu_days: posts big blind 200
*** HOLE CARDS ***
Dealt to phpro [9h 7h]
hesoma_89: folds
Andrew Willian: folds
Isr0il: folds
boensen1982: folds
phpro: folds
varen1k322: folds
Cyan Diogenes: folds
bimbas1199: raises 4600 to 4800 and is all-in
Lu_days: folds
Uncalled bet (4600) returned to bimbas1199
bimbas1199 collected 625 from pot
bimbas1199: doesn't show hand
*** SUMMARY ***
Total pot 625 | Rake 0
Seat 1: Lu_days (big blind) folded before Flop
Seat 2: hesoma_89 folded before Flop (didn't bet)
Seat 3: Andrew Willian folded before Flop (didn't bet)
Seat 4: Isr0il folded before Flop (didn't bet)
Seat 5: boensen1982 folded before Flop (didn't bet)
Seat 6: phpro folded before Flop (didn't bet)
Seat 7: varen1k322 folded before Flop (didn't bet)
Seat 8: Cyan Diogenes (button) folded before Flop (didn't bet)
Seat 9: bimbas1199 (small blind) collected (625)


*********** # 45 **************
PokerStars Hand #257046248393: Tournament #3910307458, $0.98+$0.12 USD Hold'em No Limit - Level X (125/250) - 2025/07/22 10:52:27 ET
Table '3910307458 12' 9-max Seat #9 is the button
Seat 1: Lu_days (3175 in chips)
Seat 2: hesoma_89 (6178 in chips)
Seat 3: Andrew Willian (6122 in chips)
Seat 4: Isr0il (1934 in chips)
Seat 5: boensen1982 (3850 in chips)
Seat 6: phpro (1875 in chips)
Seat 7: varen1k322 (4210 in chips)
Seat 8: Cyan Diogenes (9907 in chips)
Seat 9: bimbas1199 (5225 in chips)
Lu_days: posts the ante 30
hesoma_89: posts the ante 30
Andrew Willian: posts the ante 30
Isr0il: posts the ante 30
boensen1982: posts the ante 30
phpro: posts the ante 30
varen1k322: posts the ante 30
Cyan Diogenes: posts the ante 30
bimbas1199: posts the ante 30
Lu_days: posts small blind 125
hesoma_89: posts big blind 250
*** HOLE CARDS ***
Dealt to phpro [Jd 8c]
Andrew Willian: raises 250 to 500
Isr0il: folds
boensen1982: folds
phpro: folds
varen1k322: folds
Cyan Diogenes: folds
bimbas1199: folds
Lu_days: folds
hesoma_89: calls 250
*** FLOP *** [8h As 3c]
hesoma_89: checks
Andrew Willian: bets 460
hesoma_89: folds
Uncalled bet (460) returned to Andrew Willian
Andrew Willian collected 1395 from pot
*** SUMMARY ***
Total pot 1395 | Rake 0
Board [8h As 3c]
Seat 1: Lu_days (small blind) folded before Flop
Seat 2: hesoma_89 (big blind) folded on the Flop
Seat 3: Andrew Willian collected (1395)
Seat 4: Isr0il folded before Flop (didn't bet)
Seat 5: boensen1982 folded before Flop (didn't bet)
Seat 6: phpro folded before Flop (didn't bet)
Seat 7: varen1k322 folded before Flop (didn't bet)
Seat 8: Cyan Diogenes folded before Flop (didn't bet)
Seat 9: bimbas1199 (button) folded before Flop (didn't bet)


*********** # 46 **************
PokerStars Hand #257046254628: Tournament #3910307458, $0.98+$0.12 USD Hold'em No Limit - Level X (125/250) - 2025/07/22 10:53:06 ET
Table '3910307458 12' 9-max Seat #1 is the button
Seat 1: Lu_days (3020 in chips)
Seat 2: hesoma_89 (5648 in chips)
Seat 3: Andrew Willian (6987 in chips)
Seat 4: Isr0il (1904 in chips)
Seat 5: boensen1982 (3820 in chips)
Seat 6: phpro (1845 in chips)
Seat 7: varen1k322 (4180 in chips)
Seat 8: Cyan Diogenes (9877 in chips)
Seat 9: bimbas1199 (5195 in chips)
Lu_days: posts the ante 30
hesoma_89: posts the ante 30
Andrew Willian: posts the ante 30
Isr0il: posts the ante 30
boensen1982: posts the ante 30
phpro: posts the ante 30
varen1k322: posts the ante 30
Cyan Diogenes: posts the ante 30
bimbas1199: posts the ante 30
hesoma_89: posts small blind 125
Andrew Willian: posts big blind 250
*** HOLE CARDS ***
Dealt to phpro [3s Jd]
Isr0il: folds
boensen1982: folds
phpro: folds
varen1k322: folds
bimbas1199 is disconnected
Cyan Diogenes: folds
bimbas1199 is connected
bimbas1199 is connected
bimbas1199: folds
Lu_days: folds
hesoma_89: folds
Uncalled bet (125) returned to Andrew Willian
Andrew Willian collected 520 from pot
*** SUMMARY ***
Total pot 520 | Rake 0
Seat 1: Lu_days (button) folded before Flop (didn't bet)
Seat 2: hesoma_89 (small blind) folded before Flop
Seat 3: Andrew Willian (big blind) collected (520)
Seat 4: Isr0il folded before Flop (didn't bet)
Seat 5: boensen1982 folded before Flop (didn't bet)
Seat 6: phpro folded before Flop (didn't bet)
Seat 7: varen1k322 folded before Flop (didn't bet)
Seat 8: Cyan Diogenes folded before Flop (didn't bet)
Seat 9: bimbas1199 folded before Flop (didn't bet)


*********** # 47 **************
PokerStars Hand #257046262201: Tournament #3910307458, $0.98+$0.12 USD Hold'em No Limit - Level X (125/250) - 2025/07/22 10:53:54 ET
Table '3910307458 12' 9-max Seat #2 is the button
Seat 1: Lu_days (2990 in chips)
Seat 2: hesoma_89 (5493 in chips)
Seat 3: Andrew Willian (7352 in chips)
Seat 5: boensen1982 (3790 in chips)
Seat 6: phpro (1815 in chips)
Seat 7: varen1k322 (4150 in chips)
Seat 8: Cyan Diogenes (9847 in chips)
Seat 9: bimbas1199 (5165 in chips)
Lu_days: posts the ante 30
hesoma_89: posts the ante 30
Andrew Willian: posts the ante 30
boensen1982: posts the ante 30
phpro: posts the ante 30
varen1k322: posts the ante 30
Cyan Diogenes: posts the ante 30
bimbas1199: posts the ante 30
Andrew Willian: posts small blind 125
boensen1982: posts big blind 250
*** HOLE CARDS ***
Dealt to phpro [Th Kh]
phpro: raises 1535 to 1785 and is all-in
varen1k322: folds
Cyan Diogenes: folds
bimbas1199: folds
Lu_days: folds
hesoma_89: folds
Andrew Willian: folds
boensen1982: folds
Uncalled bet (1535) returned to phpro
phpro collected 865 from pot
phpro: doesn't show hand
*** SUMMARY ***
Total pot 865 | Rake 0
Seat 1: Lu_days folded before Flop (didn't bet)
Seat 2: hesoma_89 (button) folded before Flop (didn't bet)
Seat 3: Andrew Willian (small blind) folded before Flop
Seat 5: boensen1982 (big blind) folded before Flop
Seat 6: phpro collected (865)
Seat 7: varen1k322 folded before Flop (didn't bet)
Seat 8: Cyan Diogenes folded before Flop (didn't bet)
Seat 9: bimbas1199 folded before Flop (didn't bet)


*********** # 48 **************
PokerStars Hand #257046272785: Tournament #3910307458, $0.98+$0.12 USD Hold'em No Limit - Level X (125/250) - 2025/07/22 10:55:01 ET
Table '3910307458 12' 9-max Seat #3 is the button
Seat 1: Lu_days (2960 in chips)
Seat 2: hesoma_89 (5463 in chips)
Seat 3: Andrew Willian (7197 in chips)
Seat 4: bigdaddynat3 (3000 in chips) out of hand (moved from another table into small blind)
Seat 5: boensen1982 (3510 in chips)
Seat 6: phpro (2400 in chips)
Seat 7: varen1k322 (4120 in chips)
Seat 8: Cyan Diogenes (9817 in chips)
Seat 9: bimbas1199 (5135 in chips)
bigdaddynat3 will be allowed to play after the button
Lu_days: posts the ante 30
hesoma_89: posts the ante 30
Andrew Willian: posts the ante 30
boensen1982: posts the ante 30
phpro: posts the ante 30
varen1k322: posts the ante 30
Cyan Diogenes: posts the ante 30
bimbas1199: posts the ante 30
boensen1982: posts small blind 125
phpro: posts big blind 250
*** HOLE CARDS ***
Dealt to phpro [Th 9h]
varen1k322: folds
Cyan Diogenes: folds
bimbas1199: folds
Lu_days: folds
hesoma_89: folds
Andrew Willian: folds
boensen1982: raises 3230 to 3480 and is all-in
phpro: folds
Uncalled bet (3230) returned to boensen1982
boensen1982 collected 740 from pot
boensen1982: doesn't show hand
*** SUMMARY ***
Total pot 740 | Rake 0
Seat 1: Lu_days folded before Flop (didn't bet)
Seat 2: hesoma_89 folded before Flop (didn't bet)
Seat 3: Andrew Willian (button) folded before Flop (didn't bet)
Seat 5: boensen1982 (small blind) collected (740)
Seat 6: phpro (big blind) folded before Flop
Seat 7: varen1k322 folded before Flop (didn't bet)
Seat 8: Cyan Diogenes folded before Flop (didn't bet)
Seat 9: bimbas1199 folded before Flop (didn't bet)


*********** # 49 **************
PokerStars Hand #257046324575: Tournament #3910307458, $0.98+$0.12 USD Hold'em No Limit - Level X (125/250) - 2025/07/22 11:01:47 ET
Table '3910307458 12' 9-max Seat #5 is the button
Seat 1: Lu_days (2930 in chips)
Seat 2: hesoma_89 (5433 in chips)
Seat 3: Andrew Willian (7167 in chips)
Seat 4: bigdaddynat3 (3000 in chips)
Seat 5: boensen1982 (3970 in chips)
Seat 6: phpro (2120 in chips)
Seat 7: varen1k322 (4090 in chips)
Seat 8: Cyan Diogenes (9787 in chips)
Seat 9: bimbas1199 (5105 in chips)
Lu_days: posts the ante 30
hesoma_89: posts the ante 30
Andrew Willian: posts the ante 30
bigdaddynat3: posts the ante 30
boensen1982: posts the ante 30
phpro: posts the ante 30
varen1k322: posts the ante 30
Cyan Diogenes: posts the ante 30
bimbas1199: posts the ante 30
phpro: posts small blind 125
varen1k322: posts big blind 250
*** HOLE CARDS ***
Dealt to phpro [3c 7s]
Cyan Diogenes: raises 250 to 500
bimbas1199 has timed out
bimbas1199: folds
bimbas1199 is sitting out
Lu_days: folds
hesoma_89: folds
Andrew Willian: folds
bigdaddynat3: calls 500
boensen1982: raises 3440 to 3940 and is all-in
phpro: folds
bimbas1199 has returned
varen1k322: folds
Cyan Diogenes: folds
bigdaddynat3: folds
Uncalled bet (3440) returned to boensen1982
boensen1982 collected 2145 from pot
boensen1982: doesn't show hand
*** SUMMARY ***
Total pot 2145 | Rake 0
Seat 1: Lu_days folded before Flop (didn't bet)
Seat 2: hesoma_89 folded before Flop (didn't bet)
Seat 3: Andrew Willian folded before Flop (didn't bet)
Seat 4: bigdaddynat3 folded before Flop
Seat 5: boensen1982 (button) collected (2145)
Seat 6: phpro (small blind) folded before Flop
Seat 7: varen1k322 (big blind) folded before Flop
Seat 8: Cyan Diogenes folded before Flop
Seat 9: bimbas1199 folded before Flop (didn't bet)


*********** # 50 **************
PokerStars Hand #257046342819: Tournament #3910307458, $0.98+$0.12 USD Hold'em No Limit - Level X (125/250) - 2025/07/22 11:03:42 ET
Table '3910307458 12' 9-max Seat #6 is the button
Seat 1: Lu_days (2900 in chips)
Seat 2: hesoma_89 (5403 in chips)
Seat 3: Andrew Willian (7137 in chips)
Seat 4: bigdaddynat3 (2470 in chips)
Seat 5: boensen1982 (5585 in chips)
Seat 6: phpro (1965 in chips)
Seat 7: varen1k322 (3810 in chips)
Seat 8: Cyan Diogenes (9257 in chips)
Seat 9: bimbas1199 (5075 in chips)
Lu_days: posts the ante 30
hesoma_89: posts the ante 30
Andrew Willian: posts the ante 30
bigdaddynat3: posts the ante 30
boensen1982: posts the ante 30
phpro: posts the ante 30
varen1k322: posts the ante 30
Cyan Diogenes: posts the ante 30
bimbas1199: posts the ante 30
varen1k322: posts small blind 125
Cyan Diogenes: posts big blind 250
*** HOLE CARDS ***
Dealt to phpro [Qd Qh]
bimbas1199: folds
Lu_days: folds
hesoma_89: folds
Andrew Willian: folds
bigdaddynat3: calls 250
boensen1982: folds
phpro: raises 1685 to 1935 and is all-in
varen1k322: folds
Cyan Diogenes: folds
bigdaddynat3: calls 1685
*** FLOP *** [Ks 4d Ts]
*** TURN *** [Ks 4d Ts] [8d]
*** RIVER *** [Ks 4d Ts 8d] [3d]
*** SHOW DOWN ***
bigdaddynat3: shows [Ah 7s] (high card Ace)
phpro: shows [Qd Qh] (a pair of Queens)
phpro collected 4515 from pot
*** SUMMARY ***
Total pot 4515 | Rake 0
Board [Ks 4d Ts 8d 3d]
Seat 1: Lu_days folded before Flop (didn't bet)
Seat 2: hesoma_89 folded before Flop (didn't bet)
Seat 3: Andrew Willian folded before Flop (didn't bet)
Seat 4: bigdaddynat3 showed [Ah 7s] and lost with high card Ace
Seat 5: boensen1982 folded before Flop (didn't bet)
Seat 6: phpro (button) showed [Qd Qh] and won (4515) with a pair of Queens
Seat 7: varen1k322 (small blind) folded before Flop
Seat 8: Cyan Diogenes (big blind) folded before Flop
Seat 9: bimbas1199 folded before Flop (didn't bet)


*********** # 51 **************
PokerStars Hand #257046359590: Tournament #3910307458, $0.98+$0.12 USD Hold'em No Limit - Level X (125/250) - 2025/07/22 11:05:26 ET
Table '3910307458 12' 9-max Seat #7 is the button
Seat 1: Lu_days (2870 in chips)
Seat 2: hesoma_89 (5373 in chips)
Seat 3: Andrew Willian (7107 in chips)
Seat 4: bigdaddynat3 (505 in chips)
Seat 5: boensen1982 (5555 in chips)
Seat 6: phpro (4515 in chips)
Seat 7: varen1k322 (3655 in chips)
Seat 8: Cyan Diogenes (8977 in chips)
Seat 9: bimbas1199 (5045 in chips)
Lu_days: posts the ante 30
hesoma_89: posts the ante 30
Andrew Willian: posts the ante 30
bigdaddynat3: posts the ante 30
boensen1982: posts the ante 30
phpro: posts the ante 30
varen1k322: posts the ante 30
Cyan Diogenes: posts the ante 30
bimbas1199: posts the ante 30
Cyan Diogenes: posts small blind 125
bimbas1199: posts big blind 250
*** HOLE CARDS ***
Dealt to phpro [Qs 4h]
Lu_days: folds
hesoma_89: folds
Andrew Willian: folds
bigdaddynat3: raises 225 to 475 and is all-in
boensen1982: folds
phpro: folds
varen1k322: raises 1595 to 2070
Cyan Diogenes: folds
bimbas1199: raises 2945 to 5015 and is all-in
varen1k322: calls 1555 and is all-in
Uncalled bet (1390) returned to bimbas1199
*** FLOP *** [Jd 3c 5d]
*** TURN *** [Jd 3c 5d] [8d]
*** RIVER *** [Jd 3c 5d 8d] [6c]
*** SHOW DOWN ***
bimbas1199: shows [6d 6h] (three of a kind, Sixes)
varen1k322: shows [Kc Ad] (high card Ace)
bimbas1199 collected 6300 from side pot
bigdaddynat3: shows [2c Ah] (high card Ace)
bimbas1199 collected 1820 from main pot
varen1k322 finished the tournament in 120th place
bigdaddynat3 finished the tournament in 121st place
*** SUMMARY ***
Total pot 8120 Main pot 1820. Side pot 6300. | Rake 0
Board [Jd 3c 5d 8d 6c]
Seat 1: Lu_days folded before Flop (didn't bet)
Seat 2: hesoma_89 folded before Flop (didn't bet)
Seat 3: Andrew Willian folded before Flop (didn't bet)
Seat 4: bigdaddynat3 showed [2c Ah] and lost with high card Ace
Seat 5: boensen1982 folded before Flop (didn't bet)
Seat 6: phpro folded before Flop (didn't bet)
Seat 7: varen1k322 (button) showed [Kc Ad] and lost with high card Ace
Seat 8: Cyan Diogenes (small blind) folded before Flop
Seat 9: bimbas1199 (big blind) showed [6d 6h] and won (8120) with three of a kind, Sixes


*********** # 52 **************
PokerStars Hand #257046368387: Tournament #3910307458, $0.98+$0.12 USD Hold'em No Limit - Level X (125/250) - 2025/07/22 11:06:21 ET
Table '3910307458 12' 9-max Seat #8 is the button
Seat 1: Lu_days (2840 in chips)
Seat 2: hesoma_89 (5343 in chips)
Seat 3: Andrew Willian (7077 in chips)
Seat 5: boensen1982 (5525 in chips)
Seat 6: phpro (4485 in chips)
Seat 8: Cyan Diogenes (8822 in chips)
Seat 9: bimbas1199 (9510 in chips)
Lu_days: posts the ante 30
hesoma_89: posts the ante 30
Andrew Willian: posts the ante 30
boensen1982: posts the ante 30
phpro: posts the ante 30
Cyan Diogenes: posts the ante 30
bimbas1199: posts the ante 30
bimbas1199: posts small blind 125
Lu_days: posts big blind 250
*** HOLE CARDS ***
Dealt to phpro [Ah Ts]
D.Leonoff is disconnected
hesoma_89: folds
Andrew Willian: folds
boensen1982: folds
phpro: raises 250 to 500
Cyan Diogenes: calls 500
bimbas1199: folds
Lu_days: calls 250
*** FLOP *** [6h 6s 3h]
Lu_days: checks
7SkYy is disconnected
phpro: checks
Cyan Diogenes: bets 5750
Lu_days: folds
phpro: folds
Uncalled bet (5750) returned to Cyan Diogenes
Cyan Diogenes collected 1835 from pot
Cyan Diogenes: doesn't show hand
*** SUMMARY ***
Total pot 1835 | Rake 0
Board [6h 6s 3h]
Seat 1: Lu_days (big blind) folded on the Flop
Seat 2: hesoma_89 folded before Flop (didn't bet)
Seat 3: Andrew Willian folded before Flop (didn't bet)
Seat 5: boensen1982 folded before Flop (didn't bet)
Seat 6: phpro folded on the Flop
Seat 8: Cyan Diogenes (button) collected (1835)
Seat 9: bimbas1199 (small blind) folded before Flop


*********** # 53 **************
PokerStars Hand #257046376303: Tournament #3910307458, $0.98+$0.12 USD Hold'em No Limit - Level X (125/250) - 2025/07/22 11:07:10 ET
Table '3910307458 12' 9-max Seat #9 is the button
Seat 1: Lu_days (2310 in chips)
Seat 2: hesoma_89 (5313 in chips)
Seat 3: Andrew Willian (7047 in chips)
Seat 4: D.Leonoff (2834 in chips)
Seat 5: boensen1982 (5495 in chips)
Seat 6: phpro (3955 in chips)
Seat 7: 7SkYy (23798 in chips)
Seat 8: Cyan Diogenes (10127 in chips)
Seat 9: bimbas1199 (9355 in chips)
Lu_days: posts the ante 30
hesoma_89: posts the ante 30
Andrew Willian: posts the ante 30
D.Leonoff: posts the ante 30
boensen1982: posts the ante 30
phpro: posts the ante 30
7SkYy: posts the ante 30
Cyan Diogenes: posts the ante 30
bimbas1199: posts the ante 30
Lu_days: posts small blind 125
hesoma_89: posts big blind 250
*** HOLE CARDS ***
Dealt to phpro [8c Ad]
Andrew Willian: folds
D.Leonoff: folds
boensen1982: folds
phpro: folds
7SkYy: folds
Cyan Diogenes: folds
bimbas1199: raises 250 to 500
Lu_days: folds
hesoma_89: calls 250
*** FLOP *** [As Qd 8h]
hesoma_89: checks
bimbas1199: bets 460
hesoma_89: calls 460
*** TURN *** [As Qd 8h] [9c]
hesoma_89: checks
bimbas1199: bets 1528
hesoma_89: folds
Uncalled bet (1528) returned to bimbas1199
bimbas1199 collected 2315 from pot
bimbas1199: doesn't show hand
*** SUMMARY ***
Total pot 2315 | Rake 0
Board [As Qd 8h 9c]
Seat 1: Lu_days (small blind) folded before Flop
Seat 2: hesoma_89 (big blind) folded on the Turn
Seat 3: Andrew Willian folded before Flop (didn't bet)
Seat 4: D.Leonoff folded before Flop (didn't bet)
Seat 5: boensen1982 folded before Flop (didn't bet)
Seat 6: phpro folded before Flop (didn't bet)
Seat 7: 7SkYy folded before Flop (didn't bet)
Seat 8: Cyan Diogenes folded before Flop (didn't bet)
Seat 9: bimbas1199 (button) collected (2315)


*********** # 54 **************
PokerStars Hand #257046385006: Tournament #3910307458, $0.98+$0.12 USD Hold'em No Limit - Level X (125/250) - 2025/07/22 11:08:04 ET
Table '3910307458 12' 9-max Seat #1 is the button
Seat 1: Lu_days (2155 in chips)
Seat 2: hesoma_89 (4323 in chips)
Seat 3: Andrew Willian (7017 in chips)
Seat 4: D.Leonoff (2804 in chips)
Seat 5: boensen1982 (5465 in chips)
Seat 6: phpro (3925 in chips)
Seat 7: 7SkYy (23768 in chips)
Seat 8: Cyan Diogenes (10097 in chips)
Seat 9: bimbas1199 (10680 in chips)
Lu_days: posts the ante 30
hesoma_89: posts the ante 30
Andrew Willian: posts the ante 30
D.Leonoff: posts the ante 30
boensen1982: posts the ante 30
phpro: posts the ante 30
7SkYy: posts the ante 30
Cyan Diogenes: posts the ante 30
bimbas1199: posts the ante 30
hesoma_89: posts small blind 125
Andrew Willian: posts big blind 250
*** HOLE CARDS ***
Dealt to phpro [7d 6h]
D.Leonoff: folds
boensen1982: folds
phpro: folds
7SkYy: folds
Cyan Diogenes: raises 250 to 500
bimbas1199: folds
Lu_days: folds
hesoma_89: folds
Andrew Willian: calls 250
*** FLOP *** [8s 5h 5s]
Andrew Willian: checks
Cyan Diogenes: bets 500
Andrew Willian: raises 1000 to 1500
Cyan Diogenes: calls 1000
*** TURN *** [8s 5h 5s] [6d]
Andrew Willian: bets 1760
Cyan Diogenes: calls 1760
*** RIVER *** [8s 5h 5s 6d] [Td]
Andrew Willian: bets 3227 and is all-in
Cyan Diogenes: calls 3227
*** SHOW DOWN ***
Andrew Willian: shows [8h Js] (two pair, Eights and Fives)
Cyan Diogenes: shows [9h 7h] (a straight, Six to Ten)
Cyan Diogenes collected 14369 from pot
Andrew Willian finished the tournament in 111th place
*** SUMMARY ***
Total pot 14369 | Rake 0
Board [8s 5h 5s 6d Td]
Seat 1: Lu_days (button) folded before Flop (didn't bet)
Seat 2: hesoma_89 (small blind) folded before Flop
Seat 3: Andrew Willian (big blind) showed [8h Js] and lost with two pair, Eights and Fives
Seat 4: D.Leonoff folded before Flop (didn't bet)
Seat 5: boensen1982 folded before Flop (didn't bet)
Seat 6: phpro folded before Flop (didn't bet)
Seat 7: 7SkYy folded before Flop (didn't bet)
Seat 8: Cyan Diogenes showed [9h 7h] and won (14369) with a straight, Six to Ten
Seat 9: bimbas1199 folded before Flop (didn't bet)


*********** # 55 **************
PokerStars Hand #257046397383: Tournament #3910307458, $0.98+$0.12 USD Hold'em No Limit - Level XI (150/300) - 2025/07/22 11:09:22 ET
Table '3910307458 12' 9-max Seat #2 is the button
Seat 1: Lu_days (2125 in chips)
Seat 2: hesoma_89 (4168 in chips)
Seat 4: D.Leonoff (2774 in chips)
Seat 5: boensen1982 (5435 in chips)
Seat 6: phpro (3895 in chips)
Seat 7: 7SkYy (23738 in chips)
Seat 8: Cyan Diogenes (17449 in chips)
Seat 9: bimbas1199 (10650 in chips)
Lu_days: posts the ante 40
hesoma_89: posts the ante 40
D.Leonoff: posts the ante 40
boensen1982: posts the ante 40
phpro: posts the ante 40
7SkYy: posts the ante 40
Cyan Diogenes: posts the ante 40
bimbas1199: posts the ante 40
D.Leonoff: posts small blind 150
boensen1982: posts big blind 300
*** HOLE CARDS ***
Dealt to phpro [9h 7s]
phpro: folds
7SkYy: folds
Cyan Diogenes: folds
bimbas1199: folds
Lu_days: folds
hesoma_89: folds
D.Leonoff: folds
Uncalled bet (150) returned to boensen1982
boensen1982 collected 620 from pot
boensen1982: doesn't show hand
*** SUMMARY ***
Total pot 620 | Rake 0
Seat 1: Lu_days folded before Flop (didn't bet)
Seat 2: hesoma_89 (button) folded before Flop (didn't bet)
Seat 4: D.Leonoff (small blind) folded before Flop
Seat 5: boensen1982 (big blind) collected (620)
Seat 6: phpro folded before Flop (didn't bet)
Seat 7: 7SkYy folded before Flop (didn't bet)
Seat 8: Cyan Diogenes folded before Flop (didn't bet)
Seat 9: bimbas1199 folded before Flop (didn't bet)


*********** # 56 **************
PokerStars Hand #257046402282: Tournament #3910307458, $0.98+$0.12 USD Hold'em No Limit - Level XI (150/300) - 2025/07/22 11:09:52 ET
Table '3910307458 12' 9-max Seat #4 is the button
Seat 1: Lu_days (2085 in chips)
Seat 2: hesoma_89 (4128 in chips)
Seat 3: Tom.13733 (9125 in chips)
Seat 4: D.Leonoff (2584 in chips)
Seat 5: boensen1982 (5865 in chips)
Seat 6: phpro (3855 in chips)
Seat 7: 7SkYy (23698 in chips)
Seat 8: Cyan Diogenes (17409 in chips)
Seat 9: bimbas1199 (10610 in chips)
Lu_days: posts the ante 40
hesoma_89: posts the ante 40
Tom.13733: posts the ante 40
D.Leonoff: posts the ante 40
boensen1982: posts the ante 40
phpro: posts the ante 40
7SkYy: posts the ante 40
Cyan Diogenes: posts the ante 40
bimbas1199: posts the ante 40
boensen1982: posts small blind 150
phpro: posts big blind 300
*** HOLE CARDS ***
Dealt to phpro [4h Kh]
7SkYy: folds
Cyan Diogenes: folds
bimbas1199: folds
Lu_days: folds
hesoma_89: raises 3788 to 4088 and is all-in
Tom.13733: folds
D.Leonoff: folds
boensen1982: folds
phpro: folds
Uncalled bet (3788) returned to hesoma_89
hesoma_89 collected 1110 from pot
hesoma_89: doesn't show hand
*** SUMMARY ***
Total pot 1110 | Rake 0
Seat 1: Lu_days folded before Flop (didn't bet)
Seat 2: hesoma_89 collected (1110)
Seat 3: Tom.13733 folded before Flop (didn't bet)
Seat 4: D.Leonoff (button) folded before Flop (didn't bet)
Seat 5: boensen1982 (small blind) folded before Flop
Seat 6: phpro (big blind) folded before Flop
Seat 7: 7SkYy folded before Flop (didn't bet)
Seat 8: Cyan Diogenes folded before Flop (didn't bet)
Seat 9: bimbas1199 folded before Flop (didn't bet)


*********** # 57 **************
PokerStars Hand #257046407455: Tournament #3910307458, $0.98+$0.12 USD Hold'em No Limit - Level XI (150/300) - 2025/07/22 11:10:24 ET
Table '3910307458 12' 9-max Seat #5 is the button
Seat 1: Lu_days (2045 in chips)
Seat 2: hesoma_89 (4898 in chips)
Seat 3: Tom.13733 (9085 in chips)
Seat 4: D.Leonoff (2544 in chips)
Seat 5: boensen1982 (5675 in chips)
Seat 6: phpro (3515 in chips)
Seat 7: 7SkYy (23658 in chips)
Seat 8: Cyan Diogenes (17369 in chips)
Seat 9: bimbas1199 (10570 in chips)
Lu_days: posts the ante 40
hesoma_89: posts the ante 40
Tom.13733: posts the ante 40
D.Leonoff: posts the ante 40
boensen1982: posts the ante 40
phpro: posts the ante 40
7SkYy: posts the ante 40
Cyan Diogenes: posts the ante 40
bimbas1199: posts the ante 40
phpro: posts small blind 150
7SkYy: posts big blind 300
*** HOLE CARDS ***
Dealt to phpro [Kc 7d]
Cyan Diogenes: folds
bimbas1199: raises 300 to 600
Lu_days: folds
hesoma_89: folds
Tom.13733: calls 600
D.Leonoff: folds
boensen1982: folds
phpro: folds
7SkYy: calls 300
*** FLOP *** [6c 5h 9s]
7SkYy: checks
bimbas1199: bets 762
Tom.13733: folds
7SkYy: folds
Uncalled bet (762) returned to bimbas1199
bimbas1199 collected 2310 from pot
bimbas1199: doesn't show hand
*** SUMMARY ***
Total pot 2310 | Rake 0
Board [6c 5h 9s]
Seat 1: Lu_days folded before Flop (didn't bet)
Seat 2: hesoma_89 folded before Flop (didn't bet)
Seat 3: Tom.13733 folded on the Flop
Seat 4: D.Leonoff folded before Flop (didn't bet)
Seat 5: boensen1982 (button) folded before Flop (didn't bet)
Seat 6: phpro (small blind) folded before Flop
Seat 7: 7SkYy (big blind) folded on the Flop
Seat 8: Cyan Diogenes folded before Flop (didn't bet)
Seat 9: bimbas1199 collected (2310)


*********** # 58 **************
PokerStars Hand #257046415747: Tournament #3910307458, $0.98+$0.12 USD Hold'em No Limit - Level XI (150/300) - 2025/07/22 11:11:16 ET
Table '3910307458 12' 9-max Seat #6 is the button
Seat 1: Lu_days (2005 in chips)
Seat 2: hesoma_89 (4858 in chips)
Seat 3: Tom.13733 (8445 in chips)
Seat 4: D.Leonoff (2504 in chips)
Seat 5: boensen1982 (5635 in chips)
Seat 6: phpro (3325 in chips)
Seat 7: 7SkYy (23018 in chips)
Seat 8: Cyan Diogenes (17329 in chips)
Seat 9: bimbas1199 (12240 in chips)
Lu_days: posts the ante 40
hesoma_89: posts the ante 40
Tom.13733: posts the ante 40
D.Leonoff: posts the ante 40
boensen1982: posts the ante 40
phpro: posts the ante 40
7SkYy: posts the ante 40
Cyan Diogenes: posts the ante 40
bimbas1199: posts the ante 40
7SkYy: posts small blind 150
Cyan Diogenes: posts big blind 300
*** HOLE CARDS ***
Dealt to phpro [9d 9s]
bimbas1199: folds
Lu_days: folds
hesoma_89: folds
Tom.13733: calls 300
D.Leonoff: raises 2164 to 2464 and is all-in
boensen1982: folds
phpro: folds
7SkYy: folds
Cyan Diogenes: folds
Tom.13733: folds
Uncalled bet (2164) returned to D.Leonoff
D.Leonoff collected 1410 from pot
D.Leonoff: doesn't show hand
*** SUMMARY ***
Total pot 1410 | Rake 0
Seat 1: Lu_days folded before Flop (didn't bet)
Seat 2: hesoma_89 folded before Flop (didn't bet)
Seat 3: Tom.13733 folded before Flop
Seat 4: D.Leonoff collected (1410)
Seat 5: boensen1982 folded before Flop (didn't bet)
Seat 6: phpro (button) folded before Flop (didn't bet)
Seat 7: 7SkYy (small blind) folded before Flop
Seat 8: Cyan Diogenes (big blind) folded before Flop
Seat 9: bimbas1199 folded before Flop (didn't bet)


*********** # 59 **************
PokerStars Hand #257046424793: Tournament #3910307458, $0.98+$0.12 USD Hold'em No Limit - Level XI (150/300) - 2025/07/22 11:12:11 ET
Table '3910307458 12' 9-max Seat #7 is the button
Seat 1: Lu_days (1965 in chips)
Seat 2: hesoma_89 (4818 in chips)
Seat 3: Tom.13733 (8105 in chips)
Seat 4: D.Leonoff (3574 in chips)
Seat 5: boensen1982 (5595 in chips)
Seat 6: phpro (3285 in chips)
Seat 7: 7SkYy (22828 in chips)
Seat 8: Cyan Diogenes (16989 in chips)
Seat 9: bimbas1199 (12200 in chips)
Lu_days: posts the ante 40
hesoma_89: posts the ante 40
Tom.13733: posts the ante 40
D.Leonoff: posts the ante 40
boensen1982: posts the ante 40
phpro: posts the ante 40
7SkYy: posts the ante 40
Cyan Diogenes: posts the ante 40
bimbas1199: posts the ante 40
Cyan Diogenes: posts small blind 150
bimbas1199: posts big blind 300
*** HOLE CARDS ***
Dealt to phpro [7c Qs]
Lu_days: folds
hesoma_89: folds
Tom.13733: raises 300 to 600
D.Leonoff: folds
boensen1982: folds
phpro: folds
7SkYy: folds
Cyan Diogenes: folds
bimbas1199: folds
Uncalled bet (300) returned to Tom.13733
Tom.13733 collected 1110 from pot
*** SUMMARY ***
Total pot 1110 | Rake 0
Seat 1: Lu_days folded before Flop (didn't bet)
Seat 2: hesoma_89 folded before Flop (didn't bet)
Seat 3: Tom.13733 collected (1110)
Seat 4: D.Leonoff folded before Flop (didn't bet)
Seat 5: boensen1982 folded before Flop (didn't bet)
Seat 6: phpro folded before Flop (didn't bet)
Seat 7: 7SkYy (button) folded before Flop (didn't bet)
Seat 8: Cyan Diogenes (small blind) folded before Flop
Seat 9: bimbas1199 (big blind) folded before Flop


*********** # 60 **************
PokerStars Hand #257046431840: Tournament #3910307458, $0.98+$0.12 USD Hold'em No Limit - Level XI (150/300) - 2025/07/22 11:12:54 ET
Table '3910307458 12' 9-max Seat #8 is the button
Seat 1: Lu_days (1925 in chips)
Seat 2: hesoma_89 (4778 in chips)
Seat 3: Tom.13733 (8875 in chips)
Seat 4: D.Leonoff (3534 in chips)
Seat 5: boensen1982 (5555 in chips)
Seat 6: phpro (3245 in chips)
Seat 7: 7SkYy (22788 in chips)
Seat 8: Cyan Diogenes (16799 in chips)
Seat 9: bimbas1199 (11860 in chips)
Lu_days: posts the ante 40
hesoma_89: posts the ante 40
Tom.13733: posts the ante 40
D.Leonoff: posts the ante 40
boensen1982: posts the ante 40
phpro: posts the ante 40
7SkYy: posts the ante 40
Cyan Diogenes: posts the ante 40
bimbas1199: posts the ante 40
bimbas1199: posts small blind 150
Lu_days: posts big blind 300
*** HOLE CARDS ***
Dealt to phpro [9c 3s]
hesoma_89: folds
Tom.13733: folds
D.Leonoff: folds
boensen1982: folds
phpro: folds
7SkYy: folds
Cyan Diogenes: raises 300 to 600
bimbas1199: folds
Lu_days: calls 300
*** FLOP *** [7s 6c 4s]
Lu_days: checks
Cyan Diogenes: checks
*** TURN *** [7s 6c 4s] [6d]
Lu_days: checks
Cyan Diogenes: bets 600
Lu_days: folds
Uncalled bet (600) returned to Cyan Diogenes
Cyan Diogenes collected 1710 from pot
Cyan Diogenes: doesn't show hand
*** SUMMARY ***
Total pot 1710 | Rake 0
Board [7s 6c 4s 6d]
Seat 1: Lu_days (big blind) folded on the Turn
Seat 2: hesoma_89 folded before Flop (didn't bet)
Seat 3: Tom.13733 folded before Flop (didn't bet)
Seat 4: D.Leonoff folded before Flop (didn't bet)
Seat 5: boensen1982 folded before Flop (didn't bet)
Seat 6: phpro folded before Flop (didn't bet)
Seat 7: 7SkYy folded before Flop (didn't bet)
Seat 8: Cyan Diogenes (button) collected (1710)
Seat 9: bimbas1199 (small blind) folded before Flop


*********** # 61 **************
PokerStars Hand #257046440721: Tournament #3910307458, $0.98+$0.12 USD Hold'em No Limit - Level XI (150/300) - 2025/07/22 11:13:48 ET
Table '3910307458 12' 9-max Seat #9 is the button
Seat 1: Lu_days (1285 in chips)
Seat 2: hesoma_89 (4738 in chips)
Seat 3: Tom.13733 (8835 in chips)
Seat 4: D.Leonoff (3494 in chips)
Seat 5: boensen1982 (5515 in chips)
Seat 6: phpro (3205 in chips)
Seat 7: 7SkYy (22748 in chips)
Seat 8: Cyan Diogenes (17869 in chips)
Seat 9: bimbas1199 (11670 in chips)
Lu_days: posts the ante 40
hesoma_89: posts the ante 40
Tom.13733: posts the ante 40
D.Leonoff: posts the ante 40
boensen1982: posts the ante 40
phpro: posts the ante 40
7SkYy: posts the ante 40
Cyan Diogenes: posts the ante 40
bimbas1199: posts the ante 40
Lu_days: posts small blind 150
hesoma_89: posts big blind 300
*** HOLE CARDS ***
Dealt to phpro [8d 8s]
Tom.13733: folds
D.Leonoff: folds
boensen1982: folds
phpro: raises 300 to 600
7SkYy: folds
Cyan Diogenes: folds
bimbas1199: folds
Lu_days: folds
hesoma_89: folds
Uncalled bet (300) returned to phpro
phpro collected 1110 from pot
phpro: doesn't show hand
*** SUMMARY ***
Total pot 1110 | Rake 0
Seat 1: Lu_days (small blind) folded before Flop
Seat 2: hesoma_89 (big blind) folded before Flop
Seat 3: Tom.13733 folded before Flop (didn't bet)
Seat 4: D.Leonoff folded before Flop (didn't bet)
Seat 5: boensen1982 folded before Flop (didn't bet)
Seat 6: phpro collected (1110)
Seat 7: 7SkYy folded before Flop (didn't bet)
Seat 8: Cyan Diogenes folded before Flop (didn't bet)
Seat 9: bimbas1199 (button) folded before Flop (didn't bet)


*********** # 62 **************
PokerStars Hand #257046447519: Tournament #3910307458, $0.98+$0.12 USD Hold'em No Limit - Level XI (150/300) - 2025/07/22 11:14:30 ET
Table '3910307458 12' 9-max Seat #1 is the button
Seat 1: Lu_days (1095 in chips)
Seat 2: hesoma_89 (4398 in chips)
Seat 3: Tom.13733 (8795 in chips)
Seat 4: D.Leonoff (3454 in chips)
Seat 5: boensen1982 (5475 in chips)
Seat 6: phpro (3975 in chips)
Seat 7: 7SkYy (22708 in chips)
Seat 8: Cyan Diogenes (17829 in chips)
Seat 9: bimbas1199 (11630 in chips)
Lu_days: posts the ante 40
hesoma_89: posts the ante 40
Tom.13733: posts the ante 40
D.Leonoff: posts the ante 40
boensen1982: posts the ante 40
phpro: posts the ante 40
7SkYy: posts the ante 40
Cyan Diogenes: posts the ante 40
bimbas1199: posts the ante 40
hesoma_89: posts small blind 150
Tom.13733: posts big blind 300
*** HOLE CARDS ***
Dealt to phpro [5h 8s]
D.Leonoff: folds
boensen1982: folds
phpro: folds
7SkYy: folds
Cyan Diogenes: folds
bimbas1199: raises 300 to 600
Lu_days: raises 300 to 900
hesoma_89: folds
Tom.13733: calls 600
bimbas1199: raises 300 to 1200
Lu_days: calls 155 and is all-in
Tom.13733: calls 300
*** FLOP *** [8c 7s 6c]
Tom.13733: bets 600
bimbas1199: calls 600
*** TURN *** [8c 7s 6c] [Jc]
Tom.13733: bets 1200
bimbas1199: calls 1200
*** RIVER *** [8c 7s 6c Jc] [Ac]
Tom.13733: checks
bimbas1199: bets 2496
Tom.13733: calls 2496
*** SHOW DOWN ***
bimbas1199: shows [As Tc] (a flush, Ace high)
Tom.13733: mucks hand
bimbas1199 collected 8882 from side pot
Lu_days: mucks hand
bimbas1199 collected 3675 from main pot
Lu_days finished the tournament in 94th place
*** SUMMARY ***
Total pot 12557 Main pot 3675. Side pot 8882. | Rake 0
Board [8c 7s 6c Jc Ac]
Seat 1: Lu_days (button) mucked [Jh Js]
Seat 2: hesoma_89 (small blind) folded before Flop
Seat 3: Tom.13733 (big blind) mucked [8d 7h]
Seat 4: D.Leonoff folded before Flop (didn't bet)
Seat 5: boensen1982 folded before Flop (didn't bet)
Seat 6: phpro folded before Flop (didn't bet)
Seat 7: 7SkYy folded before Flop (didn't bet)
Seat 8: Cyan Diogenes folded before Flop (didn't bet)
Seat 9: bimbas1199 showed [As Tc] and won (12557) with a flush, Ace high


*********** # 63 **************
PokerStars Hand #257046460012: Tournament #3910307458, $0.98+$0.12 USD Hold'em No Limit - Level XI (150/300) - 2025/07/22 11:15:46 ET
Table '3910307458 12' 9-max Seat #2 is the button
Seat 2: hesoma_89 (4208 in chips)
Seat 3: Tom.13733 (3259 in chips)
Seat 4: D.Leonoff (3414 in chips)
Seat 5: boensen1982 (5435 in chips)
Seat 6: phpro (3935 in chips)
Seat 7: 7SkYy (22668 in chips)
Seat 8: Cyan Diogenes (17789 in chips)
Seat 9: bimbas1199 (18651 in chips)
hesoma_89: posts the ante 40
Tom.13733: posts the ante 40
D.Leonoff: posts the ante 40
boensen1982: posts the ante 40
phpro: posts the ante 40
7SkYy: posts the ante 40
Cyan Diogenes: posts the ante 40
bimbas1199: posts the ante 40
Tom.13733: posts small blind 150
D.Leonoff: posts big blind 300
*** HOLE CARDS ***
Dealt to phpro [Ad 5d]
boensen1982: folds
phpro: folds
7SkYy: folds
Cyan Diogenes: raises 300 to 600
bimbas1199: folds
hesoma_89: folds
Tom.13733: raises 600 to 1200
D.Leonoff: folds
Cyan Diogenes: raises 16549 to 17749 and is all-in
Tom.13733: calls 2019 and is all-in
Uncalled bet (14530) returned to Cyan Diogenes
*** FLOP *** [4h 2c 8d]
*** TURN *** [4h 2c 8d] [9d]
*** RIVER *** [4h 2c 8d 9d] [9h]
*** SHOW DOWN ***
Tom.13733: shows [Qh Kc] (a pair of Nines)
Cyan Diogenes: shows [Jh Qc] (a pair of Nines - lower kicker)
Tom.13733 collected 7058 from pot
*** SUMMARY ***
Total pot 7058 | Rake 0
Board [4h 2c 8d 9d 9h]
Seat 2: hesoma_89 (button) folded before Flop (didn't bet)
Seat 3: Tom.13733 (small blind) showed [Qh Kc] and won (7058) with a pair of Nines
Seat 4: D.Leonoff (big blind) folded before Flop
Seat 5: boensen1982 folded before Flop (didn't bet)
Seat 6: phpro folded before Flop (didn't bet)
Seat 7: 7SkYy folded before Flop (didn't bet)
Seat 8: Cyan Diogenes showed [Jh Qc] and lost with a pair of Nines
Seat 9: bimbas1199 folded before Flop (didn't bet)


*********** # 64 **************
PokerStars Hand #257046467749: Tournament #3910307458, $0.98+$0.12 USD Hold'em No Limit - Level XI (150/300) - 2025/07/22 11:16:34 ET
Table '3910307458 12' 9-max Seat #3 is the button
Seat 2: hesoma_89 (4168 in chips)
Seat 3: Tom.13733 (7058 in chips)
Seat 4: D.Leonoff (3074 in chips)
Seat 5: boensen1982 (5395 in chips)
Seat 6: phpro (3895 in chips)
Seat 7: 7SkYy (22628 in chips)
Seat 8: Cyan Diogenes (14530 in chips)
Seat 9: bimbas1199 (18611 in chips)
hesoma_89: posts the ante 40
Tom.13733: posts the ante 40
D.Leonoff: posts the ante 40
boensen1982: posts the ante 40
phpro: posts the ante 40
7SkYy: posts the ante 40
Cyan Diogenes: posts the ante 40
bimbas1199: posts the ante 40
D.Leonoff: posts small blind 150
boensen1982: posts big blind 300
*** HOLE CARDS ***
Dealt to phpro [Th Kd]
phpro: folds
7SkYy: folds
Cyan Diogenes: folds
bimbas1199: raises 300 to 600
hesoma_89: folds
Tom.13733: calls 600
D.Leonoff: raises 2434 to 3034 and is all-in
boensen1982: folds
bimbas1199: folds
Tom.13733: calls 2434
*** FLOP *** [Ks 4h 4d]
*** TURN *** [Ks 4h 4d] [Jh]
*** RIVER *** [Ks 4h 4d Jh] [2h]
*** SHOW DOWN ***
D.Leonoff: shows [Kh Ah] (a flush, Ace high)
Tom.13733: shows [Js 5s] (two pair, Jacks and Fours)
D.Leonoff collected 7288 from pot
*** SUMMARY ***
Total pot 7288 | Rake 0
Board [Ks 4h 4d Jh 2h]
Seat 2: hesoma_89 folded before Flop (didn't bet)
Seat 3: Tom.13733 (button) showed [Js 5s] and lost with two pair, Jacks and Fours
Seat 4: D.Leonoff (small blind) showed [Kh Ah] and won (7288) with a flush, Ace high
Seat 5: boensen1982 (big blind) folded before Flop
Seat 6: phpro folded before Flop (didn't bet)
Seat 7: 7SkYy folded before Flop (didn't bet)
Seat 8: Cyan Diogenes folded before Flop (didn't bet)
Seat 9: bimbas1199 folded before Flop


*********** # 65 **************
PokerStars Hand #257046474621: Tournament #3910307458, $0.98+$0.12 USD Hold'em No Limit - Level XI (150/300) - 2025/07/22 11:17:16 ET
Table '3910307458 12' 9-max Seat #4 is the button
Seat 2: hesoma_89 (4128 in chips)
Seat 3: Tom.13733 (3984 in chips)
Seat 4: D.Leonoff (7288 in chips)
Seat 5: boensen1982 (5055 in chips)
Seat 6: phpro (3855 in chips)
Seat 7: 7SkYy (22588 in chips)
Seat 8: Cyan Diogenes (14490 in chips)
Seat 9: bimbas1199 (17971 in chips)
hesoma_89: posts the ante 40
Tom.13733: posts the ante 40
D.Leonoff: posts the ante 40
boensen1982: posts the ante 40
phpro: posts the ante 40
7SkYy: posts the ante 40
Cyan Diogenes: posts the ante 40
bimbas1199: posts the ante 40
boensen1982: posts small blind 150
phpro: posts big blind 300
*** HOLE CARDS ***
Dealt to phpro [7d Td]
7SkYy: folds
Cyan Diogenes: folds
bimbas1199: folds
hesoma_89: folds
Tom.13733: raises 3644 to 3944 and is all-in
D.Leonoff: folds
boensen1982: raises 1071 to 5015 and is all-in
phpro: folds
Uncalled bet (1071) returned to boensen1982
*** FLOP *** [Jc 7h Jd]
Flávio718 is disconnected
*** TURN *** [Jc 7h Jd] [Qh]
*** RIVER *** [Jc 7h Jd Qh] [Ac]
*** SHOW DOWN ***
boensen1982: shows [Js Qs] (a full house, Jacks full of Queens)
Tom.13733: shows [5d 3c] (a pair of Jacks)
boensen1982 collected 8508 from pot
Tom.13733 finished the tournament in 90th place
*** SUMMARY ***
Total pot 8508 | Rake 0
Board [Jc 7h Jd Qh Ac]
Seat 2: hesoma_89 folded before Flop (didn't bet)
Seat 3: Tom.13733 showed [5d 3c] and lost with a pair of Jacks
Seat 4: D.Leonoff (button) folded before Flop (didn't bet)
Seat 5: boensen1982 (small blind) showed [Js Qs] and won (8508) with a full house, Jacks full of Queens
Seat 6: phpro (big blind) folded before Flop
Seat 7: 7SkYy folded before Flop (didn't bet)
Seat 8: Cyan Diogenes folded before Flop (didn't bet)
Seat 9: bimbas1199 folded before Flop (didn't bet)


*********** # 66 **************
PokerStars Hand #257046482254: Tournament #3910307458, $0.98+$0.12 USD Hold'em No Limit - Level XI (150/300) - 2025/07/22 11:18:03 ET
Table '3910307458 12' 9-max Seat #5 is the button
Seat 1: Flávio718 (4597 in chips)
Seat 2: hesoma_89 (4088 in chips)
Seat 4: D.Leonoff (7248 in chips)
Seat 5: boensen1982 (9579 in chips)
Seat 6: phpro (3515 in chips)
Seat 7: 7SkYy (22548 in chips)
Seat 8: Cyan Diogenes (14450 in chips)
Seat 9: bimbas1199 (17931 in chips)
Flávio718: posts the ante 40
hesoma_89: posts the ante 40
D.Leonoff: posts the ante 40
boensen1982: posts the ante 40
phpro: posts the ante 40
7SkYy: posts the ante 40
Cyan Diogenes: posts the ante 40
bimbas1199: posts the ante 40
phpro: posts small blind 150
7SkYy: posts big blind 300
*** HOLE CARDS ***
Dealt to phpro [5s Qc]
Cyan Diogenes: folds
bimbas1199: folds
Flávio718: folds
hesoma_89: folds
D.Leonoff: folds
boensen1982: raises 330 to 630
phpro: folds
7SkYy: calls 330
*** FLOP *** [9h Ks 7h]
7SkYy: checks
boensen1982: bets 571
7SkYy: folds
Uncalled bet (571) returned to boensen1982
boensen1982 collected 1730 from pot
boensen1982: doesn't show hand
*** SUMMARY ***
Total pot 1730 | Rake 0
Board [9h Ks 7h]
Seat 1: Flávio718 folded before Flop (didn't bet)
Seat 2: hesoma_89 folded before Flop (didn't bet)
Seat 4: D.Leonoff folded before Flop (didn't bet)
Seat 5: boensen1982 (button) collected (1730)
Seat 6: phpro (small blind) folded before Flop
Seat 7: 7SkYy (big blind) folded on the Flop
Seat 8: Cyan Diogenes folded before Flop (didn't bet)
Seat 9: bimbas1199 folded before Flop (didn't bet)


*********** # 67 **************
PokerStars Hand #257046495417: Tournament #3910307458, $0.98+$0.12 USD Hold'em No Limit - Level XII (200/400) - 2025/07/22 11:19:25 ET
Table '3910307458 12' 9-max Seat #6 is the button
Seat 1: Flávio718 (4557 in chips)
Seat 2: hesoma_89 (4048 in chips)
Seat 4: D.Leonoff (7208 in chips)
Seat 5: boensen1982 (10639 in chips)
Seat 6: phpro (3325 in chips)
Seat 7: 7SkYy (21878 in chips)
Seat 8: Cyan Diogenes (14410 in chips)
Seat 9: bimbas1199 (17891 in chips)
Flávio718: posts the ante 50
hesoma_89: posts the ante 50
D.Leonoff: posts the ante 50
boensen1982: posts the ante 50
phpro: posts the ante 50
7SkYy: posts the ante 50
Cyan Diogenes: posts the ante 50
bimbas1199: posts the ante 50
7SkYy: posts small blind 200
Cyan Diogenes: posts big blind 400
*** HOLE CARDS ***
Dealt to phpro [9c Qh]
bimbas1199: folds
Flávio718: folds
hesoma_89: folds
D.Leonoff: folds
boensen1982: folds
phpro: raises 2875 to 3275 and is all-in
7SkYy: folds
Cyan Diogenes: folds
Uncalled bet (2875) returned to phpro
phpro collected 1400 from pot
phpro: doesn't show hand
*** SUMMARY ***
Total pot 1400 | Rake 0
Seat 1: Flávio718 folded before Flop (didn't bet)
Seat 2: hesoma_89 folded before Flop (didn't bet)
Seat 4: D.Leonoff folded before Flop (didn't bet)
Seat 5: boensen1982 folded before Flop (didn't bet)
Seat 6: phpro (button) collected (1400)
Seat 7: 7SkYy (small blind) folded before Flop
Seat 8: Cyan Diogenes (big blind) folded before Flop
Seat 9: bimbas1199 folded before Flop (didn't bet)


*********** # 68 **************
PokerStars Hand #257046498849: Tournament #3910307458, $0.98+$0.12 USD Hold'em No Limit - Level XII (200/400) - 2025/07/22 11:19:46 ET
Table '3910307458 12' 9-max Seat #7 is the button
Seat 1: Flávio718 (4507 in chips)
Seat 2: hesoma_89 (3998 in chips)
Seat 4: D.Leonoff (7158 in chips)
Seat 5: boensen1982 (10589 in chips)
Seat 6: phpro (4275 in chips)
Seat 7: 7SkYy (21628 in chips)
Seat 8: Cyan Diogenes (13960 in chips)
Seat 9: bimbas1199 (17841 in chips)
Flávio718: posts the ante 50
hesoma_89: posts the ante 50
D.Leonoff: posts the ante 50
boensen1982: posts the ante 50
phpro: posts the ante 50
7SkYy: posts the ante 50
Cyan Diogenes: posts the ante 50
bimbas1199: posts the ante 50
Cyan Diogenes: posts small blind 200
bimbas1199: posts big blind 400
*** HOLE CARDS ***
Dealt to phpro [9c 6d]
Flávio718: folds
hesoma_89: folds
D.Leonoff: raises 480 to 880
boensen1982: folds
phpro: folds
7SkYy: folds
Cyan Diogenes: folds
bimbas1199: folds
Uncalled bet (480) returned to D.Leonoff
D.Leonoff collected 1400 from pot
D.Leonoff: doesn't show hand
*** SUMMARY ***
Total pot 1400 | Rake 0
Seat 1: Flávio718 folded before Flop (didn't bet)
Seat 2: hesoma_89 folded before Flop (didn't bet)
Seat 4: D.Leonoff collected (1400)
Seat 5: boensen1982 folded before Flop (didn't bet)
Seat 6: phpro folded before Flop (didn't bet)
Seat 7: 7SkYy (button) folded before Flop (didn't bet)
Seat 8: Cyan Diogenes (small blind) folded before Flop
Seat 9: bimbas1199 (big blind) folded before Flop


*********** # 69 **************
PokerStars Hand #257046503651: Tournament #3910307458, $0.98+$0.12 USD Hold'em No Limit - Level XII (200/400) - 2025/07/22 11:20:17 ET
Table '3910307458 12' 9-max Seat #8 is the button
Seat 1: Flávio718 (4457 in chips)
Seat 2: hesoma_89 (3948 in chips)
Seat 4: D.Leonoff (8108 in chips)
Seat 5: boensen1982 (10539 in chips)
Seat 6: phpro (4225 in chips)
Seat 7: 7SkYy (21578 in chips)
Seat 8: Cyan Diogenes (13710 in chips)
Seat 9: bimbas1199 (17391 in chips)
Flávio718: posts the ante 50
hesoma_89: posts the ante 50
D.Leonoff: posts the ante 50
boensen1982: posts the ante 50
phpro: posts the ante 50
7SkYy: posts the ante 50
Cyan Diogenes: posts the ante 50
bimbas1199: posts the ante 50
bimbas1199: posts small blind 200
Flávio718: posts big blind 400
*** HOLE CARDS ***
Dealt to phpro [Js Ad]
hesoma_89: folds
D.Leonoff: raises 480 to 880
boensen1982: folds
phpro: calls 880
7SkYy: folds
Cyan Diogenes: folds
bimbas1199: folds
Flávio718: calls 480
*** FLOP *** [6c Qs 5h]
Flávio718: checks
D.Leonoff: checks
phpro: checks
*** TURN *** [6c Qs 5h] [3s]
Flávio718: checks
D.Leonoff: checks
phpro: checks
*** RIVER *** [6c Qs 5h 3s] [7s]
Flávio718: checks
D.Leonoff: checks
phpro: checks
*** SHOW DOWN ***
Flávio718: shows [Jc Tc] (high card Queen)
D.Leonoff: shows [As Ks] (a flush, Ace high)
phpro: mucks hand
D.Leonoff collected 3240 from pot
*** SUMMARY ***
Total pot 3240 | Rake 0
Board [6c Qs 5h 3s 7s]
Seat 1: Flávio718 (big blind) showed [Jc Tc] and lost with high card Queen
Seat 2: hesoma_89 folded before Flop (didn't bet)
Seat 4: D.Leonoff showed [As Ks] and won (3240) with a flush, Ace high
Seat 5: boensen1982 folded before Flop (didn't bet)
Seat 6: phpro mucked [Js Ad]
Seat 7: 7SkYy folded before Flop (didn't bet)
Seat 8: Cyan Diogenes (button) folded before Flop (didn't bet)
Seat 9: bimbas1199 (small blind) folded before Flop


*********** # 70 **************
PokerStars Hand #257046515952: Tournament #3910307458, $0.98+$0.12 USD Hold'em No Limit - Level XII (200/400) - 2025/07/22 11:21:34 ET
Table '3910307458 12' 9-max Seat #9 is the button
Seat 1: Flávio718 (3527 in chips)
Seat 2: hesoma_89 (3898 in chips)
Seat 4: D.Leonoff (10418 in chips)
Seat 5: boensen1982 (10489 in chips)
Seat 6: phpro (3295 in chips)
Seat 7: 7SkYy (21528 in chips)
Seat 8: Cyan Diogenes (13660 in chips)
Seat 9: bimbas1199 (17141 in chips)
Flávio718: posts the ante 50
hesoma_89: posts the ante 50
D.Leonoff: posts the ante 50
boensen1982: posts the ante 50
phpro: posts the ante 50
7SkYy: posts the ante 50
Cyan Diogenes: posts the ante 50
bimbas1199: posts the ante 50
Flávio718: posts small blind 200
hesoma_89: posts big blind 400
*** HOLE CARDS ***
Dealt to phpro [Tc 3d]
D.Leonoff: folds
boensen1982: raises 400 to 800
phpro: folds
7SkYy: folds
Cyan Diogenes: folds
bimbas1199: raises 1400 to 2200
Flávio718: folds
hesoma_89: folds
boensen1982: calls 1400
*** FLOP *** [7h Td Js]
boensen1982: bets 1800
bimbas1199: calls 1800
*** TURN *** [7h Td Js] [6c]
boensen1982: bets 2400
bimbas1199: calls 2400
*** RIVER *** [7h Td Js 6c] [6h]
boensen1982: bets 4039 and is all-in
bimbas1199: folds
Uncalled bet (4039) returned to boensen1982
boensen1982 collected 13800 from pot
boensen1982: doesn't show hand
*** SUMMARY ***
Total pot 13800 | Rake 0
Board [7h Td Js 6c 6h]
Seat 1: Flávio718 (small blind) folded before Flop
Seat 2: hesoma_89 (big blind) folded before Flop
Seat 4: D.Leonoff folded before Flop (didn't bet)
Seat 5: boensen1982 collected (13800)
Seat 6: phpro folded before Flop (didn't bet)
Seat 7: 7SkYy folded before Flop (didn't bet)
Seat 8: Cyan Diogenes folded before Flop (didn't bet)
Seat 9: bimbas1199 (button) folded on the River


*********** # 71 **************
PokerStars Hand #257046527640: Tournament #3910307458, $0.98+$0.12 USD Hold'em No Limit - Level XII (200/400) - 2025/07/22 11:22:48 ET
Table '3910307458 12' 9-max Seat #1 is the button
Seat 1: Flávio718 (3277 in chips)
Seat 2: hesoma_89 (3448 in chips)
Seat 4: D.Leonoff (10368 in chips)
Seat 5: boensen1982 (17839 in chips)
Seat 6: phpro (3245 in chips)
Seat 7: 7SkYy (21478 in chips)
Seat 8: Cyan Diogenes (13610 in chips)
Seat 9: bimbas1199 (10691 in chips)
Flávio718: posts the ante 50
hesoma_89: posts the ante 50
D.Leonoff: posts the ante 50
boensen1982: posts the ante 50
phpro: posts the ante 50
7SkYy: posts the ante 50
Cyan Diogenes: posts the ante 50
bimbas1199: posts the ante 50
hesoma_89: posts small blind 200
D.Leonoff: posts big blind 400
*** HOLE CARDS ***
Dealt to phpro [7c Qs]
boensen1982: raises 400 to 800
phpro: folds
7SkYy: folds
Cyan Diogenes: folds
bimbas1199: folds
Flávio718: raises 2427 to 3227 and is all-in
hesoma_89: folds
D.Leonoff: folds
boensen1982: calls 2427
*** FLOP *** [As Ts 2h]
*** TURN *** [As Ts 2h] [4c]
*** RIVER *** [As Ts 2h 4c] [Ah]
*** SHOW DOWN ***
boensen1982: shows [8c Ac] (three of a kind, Aces)
Flávio718: shows [9c Qd] (a pair of Aces)
boensen1982 collected 7454 from pot
Flávio718 finished the tournament in 83rd place
*** SUMMARY ***
Total pot 7454 | Rake 0
Board [As Ts 2h 4c Ah]
Seat 1: Flávio718 (button) showed [9c Qd] and lost with a pair of Aces
Seat 2: hesoma_89 (small blind) folded before Flop
Seat 4: D.Leonoff (big blind) folded before Flop
Seat 5: boensen1982 showed [8c Ac] and won (7454) with three of a kind, Aces
Seat 6: phpro folded before Flop (didn't bet)
Seat 7: 7SkYy folded before Flop (didn't bet)
Seat 8: Cyan Diogenes folded before Flop (didn't bet)
Seat 9: bimbas1199 folded before Flop (didn't bet)


*********** # 72 **************
PokerStars Hand #257046533492: Tournament #3910307458, $0.98+$0.12 USD Hold'em No Limit - Level XII (200/400) - 2025/07/22 11:23:26 ET
Table '3910307458 12' 9-max Seat #2 is the button
Seat 2: hesoma_89 (3198 in chips)
Seat 4: D.Leonoff (9918 in chips)
Seat 5: boensen1982 (22016 in chips)
Seat 6: phpro (3195 in chips)
Seat 7: 7SkYy (21428 in chips)
Seat 8: Cyan Diogenes (13560 in chips)
Seat 9: bimbas1199 (10641 in chips)
hesoma_89: posts the ante 50
D.Leonoff: posts the ante 50
boensen1982: posts the ante 50
phpro: posts the ante 50
7SkYy: posts the ante 50
Cyan Diogenes: posts the ante 50
bimbas1199: posts the ante 50
D.Leonoff: posts small blind 200
boensen1982: posts big blind 400
*** HOLE CARDS ***
Dealt to phpro [6d Qc]
cpbf is disconnected
phpro: folds
7SkYy: folds
Cyan Diogenes: folds
bimbas1199: folds
hesoma_89: folds
D.Leonoff: raises 400 to 800
boensen1982: calls 400
*** FLOP *** [Kc Ah 3h]
D.Leonoff: checks
boensen1982: checks
*** TURN *** [Kc Ah 3h] [5d]
D.Leonoff: bets 644
boensen1982: folds
Uncalled bet (644) returned to D.Leonoff
D.Leonoff collected 1950 from pot
D.Leonoff: doesn't show hand
*** SUMMARY ***
Total pot 1950 | Rake 0
Board [Kc Ah 3h 5d]
Seat 2: hesoma_89 (button) folded before Flop (didn't bet)
Seat 4: D.Leonoff (small blind) collected (1950)
Seat 5: boensen1982 (big blind) folded on the Turn
Seat 6: phpro folded before Flop (didn't bet)
Seat 7: 7SkYy folded before Flop (didn't bet)
Seat 8: Cyan Diogenes folded before Flop (didn't bet)
Seat 9: bimbas1199 folded before Flop (didn't bet)


*********** # 73 **************
PokerStars Hand #257046540678: Tournament #3910307458, $0.98+$0.12 USD Hold'em No Limit - Level XII (200/400) - 2025/07/22 11:24:11 ET
Table '3910307458 12' 9-max Seat #4 is the button
Seat 2: hesoma_89 (3148 in chips)
Seat 3: cpbf (6504 in chips)
Seat 4: D.Leonoff (11018 in chips)
Seat 5: boensen1982 (21166 in chips)
Seat 6: phpro (3145 in chips)
Seat 7: 7SkYy (21378 in chips)
Seat 8: Cyan Diogenes (13510 in chips)
Seat 9: bimbas1199 (10591 in chips)
hesoma_89: posts the ante 50
cpbf: posts the ante 50
D.Leonoff: posts the ante 50
boensen1982: posts the ante 50
phpro: posts the ante 50
7SkYy: posts the ante 50
Cyan Diogenes: posts the ante 50
bimbas1199: posts the ante 50
boensen1982: posts small blind 200
phpro: posts big blind 400
*** HOLE CARDS ***
Dealt to phpro [Td Kd]
7SkYy: folds
Cyan Diogenes: folds
bimbas1199: raises 400 to 800
hesoma_89: folds
cpbf: raises 5654 to 6454 and is all-in
D.Leonoff: folds
boensen1982: folds
phpro: folds
bimbas1199: calls 5654
*** FLOP *** [Kh 2d Jc]
*** TURN *** [Kh 2d Jc] [4c]
*** RIVER *** [Kh 2d Jc 4c] [9h]
*** SHOW DOWN ***
bimbas1199: shows [As 9s] (a pair of Nines)
cpbf: shows [Kc Ks] (three of a kind, Kings)
cpbf collected 13908 from pot
*** SUMMARY ***
Total pot 13908 | Rake 0
Board [Kh 2d Jc 4c 9h]
Seat 2: hesoma_89 folded before Flop (didn't bet)
Seat 3: cpbf showed [Kc Ks] and won (13908) with three of a kind, Kings
Seat 4: D.Leonoff (button) folded before Flop (didn't bet)
Seat 5: boensen1982 (small blind) folded before Flop
Seat 6: phpro (big blind) folded before Flop
Seat 7: 7SkYy folded before Flop (didn't bet)
Seat 8: Cyan Diogenes folded before Flop (didn't bet)
Seat 9: bimbas1199 showed [As 9s] and lost with a pair of Nines


*********** # 74 **************
PokerStars Hand #257046547222: Tournament #3910307458, $0.98+$0.12 USD Hold'em No Limit - Level XII (200/400) - 2025/07/22 11:24:53 ET
Table '3910307458 12' 9-max Seat #5 is the button
Seat 2: hesoma_89 (3098 in chips)
Seat 3: cpbf (13908 in chips)
Seat 4: D.Leonoff (10968 in chips)
Seat 5: boensen1982 (20916 in chips)
Seat 6: phpro (2695 in chips)
Seat 7: 7SkYy (21328 in chips)
Seat 8: Cyan Diogenes (13460 in chips)
Seat 9: bimbas1199 (4087 in chips)
hesoma_89: posts the ante 50
cpbf: posts the ante 50
D.Leonoff: posts the ante 50
boensen1982: posts the ante 50
phpro: posts the ante 50
7SkYy: posts the ante 50
Cyan Diogenes: posts the ante 50
bimbas1199: posts the ante 50
phpro: posts small blind 200
7SkYy: posts big blind 400
*** HOLE CARDS ***
Dealt to phpro [Ac 8d]
vs71 is disconnected
Cyan Diogenes: folds
bimbas1199: folds
hesoma_89: folds
cpbf: folds
D.Leonoff: raises 440 to 840
boensen1982: folds
phpro: raises 1805 to 2645 and is all-in
7SkYy: folds
D.Leonoff: calls 1805
*** FLOP *** [7c Ks Td]
*** TURN *** [7c Ks Td] [Kc]
*** RIVER *** [7c Ks Td Kc] [Qc]
*** SHOW DOWN ***
phpro: shows [Ac 8d] (a pair of Kings)
D.Leonoff: shows [Ah 6c] (a pair of Kings)
phpro collected 3045 from pot
D.Leonoff collected 3045 from pot
*** SUMMARY ***
Total pot 6090 | Rake 0
Board [7c Ks Td Kc Qc]
Seat 2: hesoma_89 folded before Flop (didn't bet)
Seat 3: cpbf folded before Flop (didn't bet)
Seat 4: D.Leonoff showed [Ah 6c] and won (3045) with a pair of Kings
Seat 5: boensen1982 (button) folded before Flop (didn't bet)
Seat 6: phpro (small blind) showed [Ac 8d] and won (3045) with a pair of Kings
Seat 7: 7SkYy (big blind) folded before Flop
Seat 8: Cyan Diogenes folded before Flop (didn't bet)
Seat 9: bimbas1199 folded before Flop (didn't bet)


*********** # 75 **************
PokerStars Hand #257046556041: Tournament #3910307458, $0.98+$0.12 USD Hold'em No Limit - Level XII (200/400) - 2025/07/22 11:25:49 ET
Table '3910307458 12' 9-max Seat #6 is the button
Seat 1: vs71 (1625 in chips)
Seat 2: hesoma_89 (3048 in chips)
Seat 3: cpbf (13858 in chips)
Seat 4: D.Leonoff (11318 in chips)
Seat 5: boensen1982 (20866 in chips)
Seat 6: phpro (3045 in chips)
Seat 7: 7SkYy (20878 in chips)
Seat 8: Cyan Diogenes (13410 in chips)
Seat 9: bimbas1199 (4037 in chips)
vs71: posts the ante 50
hesoma_89: posts the ante 50
cpbf: posts the ante 50
D.Leonoff: posts the ante 50
boensen1982: posts the ante 50
phpro: posts the ante 50
7SkYy: posts the ante 50
Cyan Diogenes: posts the ante 50
bimbas1199: posts the ante 50
7SkYy: posts small blind 200
Cyan Diogenes: posts big blind 400
*** HOLE CARDS ***
Dealt to phpro [Qh 9s]
bimbas1199: folds
vs71: folds
hesoma_89: folds
cpbf: folds
D.Leonoff: folds
boensen1982: folds
phpro: raises 2595 to 2995 and is all-in
7SkYy: folds
Cyan Diogenes: calls 2595
*** FLOP *** [Ad 5h 6h]
*** TURN *** [Ad 5h 6h] [9c]
*** RIVER *** [Ad 5h 6h 9c] [8c]
*** SHOW DOWN ***
Cyan Diogenes: shows [Qd Ks] (high card Ace)
phpro: shows [Qh 9s] (a pair of Nines)
phpro collected 6640 from pot
*** SUMMARY ***
Total pot 6640 | Rake 0
Board [Ad 5h 6h 9c 8c]
Seat 1: vs71 folded before Flop (didn't bet)
Seat 2: hesoma_89 folded before Flop (didn't bet)
Seat 3: cpbf folded before Flop (didn't bet)
Seat 4: D.Leonoff folded before Flop (didn't bet)
Seat 5: boensen1982 folded before Flop (didn't bet)
Seat 6: phpro (button) showed [Qh 9s] and won (6640) with a pair of Nines
Seat 7: 7SkYy (small blind) folded before Flop
Seat 8: Cyan Diogenes (big blind) showed [Qd Ks] and lost with high card Ace
Seat 9: bimbas1199 folded before Flop (didn't bet)


*********** # 76 **************
PokerStars Hand #257046562670: Tournament #3910307458, $0.98+$0.12 USD Hold'em No Limit - Level XII (200/400) - 2025/07/22 11:26:31 ET
Table '3910307458 12' 9-max Seat #7 is the button
Seat 1: vs71 (1575 in chips)
Seat 2: hesoma_89 (2998 in chips)
Seat 3: cpbf (13808 in chips)
Seat 4: D.Leonoff (11268 in chips)
Seat 5: boensen1982 (20816 in chips)
Seat 6: phpro (6640 in chips)
Seat 7: 7SkYy (20628 in chips)
Seat 8: Cyan Diogenes (10365 in chips)
Seat 9: bimbas1199 (3987 in chips)
vs71: posts the ante 50
hesoma_89: posts the ante 50
cpbf: posts the ante 50
D.Leonoff: posts the ante 50
boensen1982: posts the ante 50
phpro: posts the ante 50
7SkYy: posts the ante 50
Cyan Diogenes: posts the ante 50
bimbas1199: posts the ante 50
Cyan Diogenes: posts small blind 200
bimbas1199: posts big blind 400
*** HOLE CARDS ***
Dealt to phpro [8d As]
vs71: folds
hesoma_89: folds
cpbf: folds
D.Leonoff: folds
boensen1982: folds
phpro: folds
7SkYy: folds
Cyan Diogenes: folds
Uncalled bet (200) returned to bimbas1199
bimbas1199 collected 850 from pot
bimbas1199: doesn't show hand
*** SUMMARY ***
Total pot 850 | Rake 0
Seat 1: vs71 folded before Flop (didn't bet)
Seat 2: hesoma_89 folded before Flop (didn't bet)
Seat 3: cpbf folded before Flop (didn't bet)
Seat 4: D.Leonoff folded before Flop (didn't bet)
Seat 5: boensen1982 folded before Flop (didn't bet)
Seat 6: phpro folded before Flop (didn't bet)
Seat 7: 7SkYy (button) folded before Flop (didn't bet)
Seat 8: Cyan Diogenes (small blind) folded before Flop
Seat 9: bimbas1199 (big blind) collected (850)


*********** # 77 **************
PokerStars Hand #257046567305: Tournament #3910307458, $0.98+$0.12 USD Hold'em No Limit - Level XII (200/400) - 2025/07/22 11:27:00 ET
Table '3910307458 12' 9-max Seat #8 is the button
Seat 1: vs71 (1525 in chips)
Seat 2: hesoma_89 (2948 in chips)
Seat 3: cpbf (13758 in chips)
Seat 4: D.Leonoff (11218 in chips)
Seat 5: boensen1982 (20766 in chips)
Seat 6: phpro (6590 in chips)
Seat 7: 7SkYy (20578 in chips)
Seat 8: Cyan Diogenes (10115 in chips)
Seat 9: bimbas1199 (4587 in chips)
vs71: posts the ante 50
hesoma_89: posts the ante 50
cpbf: posts the ante 50
D.Leonoff: posts the ante 50
boensen1982: posts the ante 50
phpro: posts the ante 50
7SkYy: posts the ante 50
Cyan Diogenes: posts the ante 50
bimbas1199: posts the ante 50
bimbas1199: posts small blind 200
vs71: posts big blind 400
*** HOLE CARDS ***
Dealt to phpro [3s 8h]
hesoma_89: folds
cpbf: folds
D.Leonoff: raises 480 to 880
boensen1982: folds
phpro: folds
7SkYy: folds
Cyan Diogenes: folds
bimbas1199: raises 3657 to 4537 and is all-in
vs71: folds
D.Leonoff: calls 3657
*** FLOP *** [Ad 7h Jd]
*** TURN *** [Ad 7h Jd] [Qc]
*** RIVER *** [Ad 7h Jd Qc] [3h]
*** SHOW DOWN ***
bimbas1199: shows [8c Ac] (a pair of Aces)
D.Leonoff: shows [Ah Jh] (two pair, Aces and Jacks)
D.Leonoff collected 9924 from pot
bimbas1199 finished the tournament in 78th place
*** SUMMARY ***
Total pot 9924 | Rake 0
Board [Ad 7h Jd Qc 3h]
Seat 1: vs71 (big blind) folded before Flop
Seat 2: hesoma_89 folded before Flop (didn't bet)
Seat 3: cpbf folded before Flop (didn't bet)
Seat 4: D.Leonoff showed [Ah Jh] and won (9924) with two pair, Aces and Jacks
Seat 5: boensen1982 folded before Flop (didn't bet)
Seat 6: phpro folded before Flop (didn't bet)
Seat 7: 7SkYy folded before Flop (didn't bet)
Seat 8: Cyan Diogenes (button) folded before Flop (didn't bet)
Seat 9: bimbas1199 (small blind) showed [8c Ac] and lost with a pair of Aces


*********** # 78 **************
PokerStars Hand #257046574375: Tournament #3910307458, $0.98+$0.12 USD Hold'em No Limit - Level XII (200/400) - 2025/07/22 11:27:45 ET
Table '3910307458 12' 9-max Seat #1 is the button
Seat 1: vs71 (1075 in chips)
Seat 2: hesoma_89 (2898 in chips)
Seat 3: cpbf (13708 in chips)
Seat 4: D.Leonoff (16555 in chips)
Seat 5: boensen1982 (20716 in chips)
Seat 6: phpro (6540 in chips)
Seat 7: 7SkYy (20528 in chips)
Seat 8: Cyan Diogenes (10065 in chips)
vs71: posts the ante 50
hesoma_89: posts the ante 50
cpbf: posts the ante 50
D.Leonoff: posts the ante 50
boensen1982: posts the ante 50
phpro: posts the ante 50
7SkYy: posts the ante 50
Cyan Diogenes: posts the ante 50
hesoma_89: posts small blind 200
cpbf: posts big blind 400
*** HOLE CARDS ***
Dealt to phpro [Jd 7s]
D.Leonoff: raises 480 to 880
boensen1982: folds
phpro: folds
7SkYy has timed out
7SkYy: folds
7SkYy is sitting out
Cyan Diogenes: folds
7SkYy has returned
vs71: folds
hesoma_89: folds
cpbf: folds
Uncalled bet (480) returned to D.Leonoff
D.Leonoff collected 1400 from pot
D.Leonoff: doesn't show hand
*** SUMMARY ***
Total pot 1400 | Rake 0
Seat 1: vs71 (button) folded before Flop (didn't bet)
Seat 2: hesoma_89 (small blind) folded before Flop
Seat 3: cpbf (big blind) folded before Flop
Seat 4: D.Leonoff collected (1400)
Seat 5: boensen1982 folded before Flop (didn't bet)
Seat 6: phpro folded before Flop (didn't bet)
Seat 7: 7SkYy folded before Flop (didn't bet)
Seat 8: Cyan Diogenes folded before Flop (didn't bet)


*********** # 79 **************
PokerStars Hand #257046582924: Tournament #3910307458, $0.98+$0.12 USD Hold'em No Limit - Level XIII (250/500) - 2025/07/22 11:28:39 ET
Table '3910307458 12' 9-max Seat #2 is the button
Seat 1: vs71 (1025 in chips)
Seat 2: hesoma_89 (2648 in chips)
Seat 3: cpbf (13258 in chips)
Seat 4: D.Leonoff (17505 in chips)
Seat 5: boensen1982 (20666 in chips)
Seat 6: phpro (6490 in chips)
Seat 7: 7SkYy (20478 in chips)
Seat 8: Cyan Diogenes (10015 in chips)
vs71: posts the ante 60
hesoma_89: posts the ante 60
cpbf: posts the ante 60
D.Leonoff: posts the ante 60
boensen1982: posts the ante 60
phpro: posts the ante 60
7SkYy: posts the ante 60
Cyan Diogenes: posts the ante 60
cpbf: posts small blind 250
D.Leonoff: posts big blind 500
*** HOLE CARDS ***
Dealt to phpro [Qc Js]
boensen1982: folds
phpro: folds
7SkYy: folds
Cyan Diogenes: raises 9455 to 9955 and is all-in
vs71: folds
hesoma_89: folds
cpbf: folds
D.Leonoff: folds
Uncalled bet (9455) returned to Cyan Diogenes
Cyan Diogenes collected 1730 from pot
Cyan Diogenes: doesn't show hand
*** SUMMARY ***
Total pot 1730 | Rake 0
Seat 1: vs71 folded before Flop (didn't bet)
Seat 2: hesoma_89 (button) folded before Flop (didn't bet)
Seat 3: cpbf (small blind) folded before Flop
Seat 4: D.Leonoff (big blind) folded before Flop
Seat 5: boensen1982 folded before Flop (didn't bet)
Seat 6: phpro folded before Flop (didn't bet)
Seat 7: 7SkYy folded before Flop (didn't bet)
Seat 8: Cyan Diogenes collected (1730)


*********** # 80 **************
PokerStars Hand #257046588044: Tournament #3910307458, $0.98+$0.12 USD Hold'em No Limit - Level XIII (250/500) - 2025/07/22 11:29:11 ET
Table '3910307458 12' 9-max Seat #3 is the button
Seat 1: vs71 (965 in chips)
Seat 2: hesoma_89 (2588 in chips)
Seat 3: cpbf (12948 in chips)
Seat 4: D.Leonoff (16945 in chips)
Seat 5: boensen1982 (20606 in chips)
Seat 6: phpro (6430 in chips)
Seat 7: 7SkYy (20418 in chips)
Seat 8: Cyan Diogenes (11185 in chips)
vs71: posts the ante 60
hesoma_89: posts the ante 60
cpbf: posts the ante 60
D.Leonoff: posts the ante 60
boensen1982: posts the ante 60
phpro: posts the ante 60
7SkYy: posts the ante 60
Cyan Diogenes: posts the ante 60
D.Leonoff: posts small blind 250
boensen1982: posts big blind 500
*** HOLE CARDS ***
Dealt to phpro [Qh 2d]
phpro: folds
7SkYy: raises 500 to 1000
Cyan Diogenes: folds
vs71: folds
hesoma_89: folds
cpbf: folds
D.Leonoff: folds
boensen1982: calls 500
*** FLOP *** [7s 5s 4h]
boensen1982: checks
7SkYy: bets 901
boensen1982: calls 901
*** TURN *** [7s 5s 4h] [4d]
boensen1982: bets 1750
7SkYy: calls 1750
*** RIVER *** [7s 5s 4h 4d] [6h]
boensen1982: bets 1750
7SkYy: calls 1750
*** SHOW DOWN ***
boensen1982: shows [6c Jc] (two pair, Sixes and Fours)
7SkYy: shows [3s As] (a straight, Three to Seven)
7SkYy collected 11532 from pot
*** SUMMARY ***
Total pot 11532 | Rake 0
Board [7s 5s 4h 4d 6h]
Seat 1: vs71 folded before Flop (didn't bet)
Seat 2: hesoma_89 folded before Flop (didn't bet)
Seat 3: cpbf (button) folded before Flop (didn't bet)
Seat 4: D.Leonoff (small blind) folded before Flop
Seat 5: boensen1982 (big blind) showed [6c Jc] and lost with two pair, Sixes and Fours
Seat 6: phpro folded before Flop (didn't bet)
Seat 7: 7SkYy showed [3s As] and won (11532) with a straight, Three to Seven
Seat 8: Cyan Diogenes folded before Flop (didn't bet)


*********** # 81 **************
PokerStars Hand #257046601337: Tournament #3910307458, $0.98+$0.12 USD Hold'em No Limit - Level XIII (250/500) - 2025/07/22 11:30:33 ET
Table '3910307458 12' 9-max Seat #4 is the button
Seat 1: vs71 (905 in chips)
Seat 2: hesoma_89 (2528 in chips)
Seat 3: cpbf (12888 in chips)
Seat 4: D.Leonoff (16635 in chips)
Seat 5: boensen1982 (15145 in chips)
Seat 6: phpro (6370 in chips)
Seat 7: 7SkYy (26489 in chips)
Seat 8: Cyan Diogenes (11125 in chips)
Seat 9: khaleel757 (12703 in chips)
vs71: posts the ante 60
hesoma_89: posts the ante 60
cpbf: posts the ante 60
D.Leonoff: posts the ante 60
boensen1982: posts the ante 60
phpro: posts the ante 60
7SkYy: posts the ante 60
Cyan Diogenes: posts the ante 60
khaleel757: posts the ante 60
boensen1982: posts small blind 250
phpro: posts big blind 500
*** HOLE CARDS ***
Dealt to phpro [Ah 2s]
7SkYy: folds
Cyan Diogenes: folds
khaleel757: folds
vs71: folds
hesoma_89: raises 1968 to 2468 and is all-in
cpbf: folds
D.Leonoff: folds
boensen1982: calls 2218
phpro: folds
*** FLOP *** [8h 9d Qs]
*** TURN *** [8h 9d Qs] [7h]
*** RIVER *** [8h 9d Qs 7h] [2d]
*** SHOW DOWN ***
boensen1982: shows [9s 8s] (two pair, Nines and Eights)
hesoma_89: shows [4d 4h] (a pair of Fours)
boensen1982 collected 5976 from pot
hesoma_89 finished the tournament in 72nd place
*** SUMMARY ***
Total pot 5976 | Rake 0
Board [8h 9d Qs 7h 2d]
Seat 1: vs71 folded before Flop (didn't bet)
Seat 2: hesoma_89 showed [4d 4h] and lost with a pair of Fours
Seat 3: cpbf folded before Flop (didn't bet)
Seat 4: D.Leonoff (button) folded before Flop (didn't bet)
Seat 5: boensen1982 (small blind) showed [9s 8s] and won (5976) with two pair, Nines and Eights
Seat 6: phpro (big blind) folded before Flop
Seat 7: 7SkYy folded before Flop (didn't bet)
Seat 8: Cyan Diogenes folded before Flop (didn't bet)
Seat 9: khaleel757 folded before Flop (didn't bet)


*********** # 82 **************
PokerStars Hand #257046607770: Tournament #3910307458, $0.98+$0.12 USD Hold'em No Limit - Level XIII (250/500) - 2025/07/22 11:31:13 ET
Table '3910307458 12' 9-max Seat #5 is the button
Seat 1: vs71 (845 in chips)
Seat 3: cpbf (12828 in chips)
Seat 4: D.Leonoff (16575 in chips)
Seat 5: boensen1982 (18593 in chips)
Seat 6: phpro (5810 in chips)
Seat 7: 7SkYy (26429 in chips)
Seat 8: Cyan Diogenes (11065 in chips)
Seat 9: khaleel757 (12643 in chips)
vs71: posts the ante 60
cpbf: posts the ante 60
D.Leonoff: posts the ante 60
boensen1982: posts the ante 60
phpro: posts the ante 60
7SkYy: posts the ante 60
Cyan Diogenes: posts the ante 60
khaleel757: posts the ante 60
phpro: posts small blind 250
7SkYy: posts big blind 500
*** HOLE CARDS ***
Dealt to phpro [4s Ad]
Cyan Diogenes: folds
khaleel757: folds
vs71: raises 285 to 785 and is all-in
cpbf: folds
D.Leonoff: folds
boensen1982: folds
phpro: calls 535
7SkYy: calls 285
*** FLOP *** [4h 4c As]
phpro: bets 936
7SkYy: folds
Uncalled bet (936) returned to phpro
*** TURN *** [4h 4c As] [Qc]
*** RIVER *** [4h 4c As Qc] [5c]
*** SHOW DOWN ***
phpro: shows [4s Ad] (a full house, Fours full of Aces)
vs71: shows [Ac 3d] (two pair, Aces and Fours)
phpro collected 2835 from pot
vs71 finished the tournament in 66th place
*** SUMMARY ***
Total pot 2835 | Rake 0
Board [4h 4c As Qc 5c]
Seat 1: vs71 showed [Ac 3d] and lost with two pair, Aces and Fours
Seat 3: cpbf folded before Flop (didn't bet)
Seat 4: D.Leonoff folded before Flop (didn't bet)
Seat 5: boensen1982 (button) folded before Flop (didn't bet)
Seat 6: phpro (small blind) showed [4s Ad] and won (2835) with a full house, Fours full of Aces
Seat 7: 7SkYy (big blind) folded on the Flop
Seat 8: Cyan Diogenes folded before Flop (didn't bet)
Seat 9: khaleel757 folded before Flop (didn't bet)


*********** # 83 **************
PokerStars Hand #257046628832: Tournament #3910307458, $0.98+$0.12 USD Hold'em No Limit - Level XIII (250/500) - 2025/07/22 11:33:21 ET
Table '3910307458 12' 9-max Seat #6 is the button
Seat 3: cpbf (12768 in chips)
Seat 4: D.Leonoff (16515 in chips)
Seat 5: boensen1982 (18533 in chips)
Seat 6: phpro (7800 in chips)
Seat 7: 7SkYy (25584 in chips)
Seat 8: Cyan Diogenes (11005 in chips)
Seat 9: khaleel757 (12583 in chips)
cpbf: posts the ante 60
D.Leonoff: posts the ante 60
boensen1982: posts the ante 60
phpro: posts the ante 60
7SkYy: posts the ante 60
Cyan Diogenes: posts the ante 60
khaleel757: posts the ante 60
7SkYy: posts small blind 250
Cyan Diogenes: posts big blind 500
*** HOLE CARDS ***
Dealt to phpro [Qh 9c]
markudown is disconnected
khaleel757: folds
cpbf: folds
D.Leonoff: raises 600 to 1100
boensen1982: folds
phpro: folds
7SkYy: folds
Cyan Diogenes: calls 600
*** FLOP *** [5s 7s Th]
Cyan Diogenes: checks
D.Leonoff: bets 1435
Cyan Diogenes: folds
Uncalled bet (1435) returned to D.Leonoff
D.Leonoff collected 2870 from pot
D.Leonoff: doesn't show hand
*** SUMMARY ***
Total pot 2870 | Rake 0
Board [5s 7s Th]
Seat 3: cpbf folded before Flop (didn't bet)
Seat 4: D.Leonoff collected (2870)
Seat 5: boensen1982 folded before Flop (didn't bet)
Seat 6: phpro (button) folded before Flop (didn't bet)
Seat 7: 7SkYy (small blind) folded before Flop
Seat 8: Cyan Diogenes (big blind) folded on the Flop
Seat 9: khaleel757 folded before Flop (didn't bet)


*********** # 84 **************
PokerStars Hand #257046635731: Tournament #3910307458, $0.98+$0.12 USD Hold'em No Limit - Level XIII (250/500) - 2025/07/22 11:34:04 ET
Table '3910307458 12' 9-max Seat #7 is the button
Seat 1: markudown (13877 in chips)
Seat 3: cpbf (12708 in chips)
Seat 4: D.Leonoff (18225 in chips)
Seat 5: boensen1982 (18473 in chips)
Seat 6: phpro (7740 in chips)
Seat 7: 7SkYy (25274 in chips)
Seat 8: Cyan Diogenes (9845 in chips)
Seat 9: khaleel757 (12523 in chips)
markudown: posts the ante 60
cpbf: posts the ante 60
D.Leonoff: posts the ante 60
boensen1982: posts the ante 60
phpro: posts the ante 60
7SkYy: posts the ante 60
Cyan Diogenes: posts the ante 60
khaleel757: posts the ante 60
Cyan Diogenes: posts small blind 250
khaleel757: posts big blind 500
*** HOLE CARDS ***
Dealt to phpro [7h Kc]
markudown has timed out
markudown: folds
markudown is sitting out
markudown has returned
cpbf: folds
D.Leonoff: folds
boensen1982: folds
phpro: folds
7SkYy: folds
Cyan Diogenes: folds
Uncalled bet (250) returned to khaleel757
khaleel757 collected 980 from pot
*** SUMMARY ***
Total pot 980 | Rake 0
Seat 1: markudown folded before Flop (didn't bet)
Seat 3: cpbf folded before Flop (didn't bet)
Seat 4: D.Leonoff folded before Flop (didn't bet)
Seat 5: boensen1982 folded before Flop (didn't bet)
Seat 6: phpro folded before Flop (didn't bet)
Seat 7: 7SkYy (button) folded before Flop (didn't bet)
Seat 8: Cyan Diogenes (small blind) folded before Flop
Seat 9: khaleel757 (big blind) collected (980)


*********** # 85 **************
PokerStars Hand #257046644346: Tournament #3910307458, $0.98+$0.12 USD Hold'em No Limit - Level XIII (250/500) - 2025/07/22 11:34:55 ET
Table '3910307458 12' 9-max Seat #8 is the button
Seat 1: markudown (13817 in chips)
Seat 3: cpbf (12648 in chips)
Seat 4: D.Leonoff (18165 in chips)
Seat 5: boensen1982 (18413 in chips)
Seat 6: phpro (7680 in chips)
Seat 7: 7SkYy (25214 in chips)
Seat 8: Cyan Diogenes (9535 in chips)
Seat 9: khaleel757 (13193 in chips)
markudown: posts the ante 60
cpbf: posts the ante 60
D.Leonoff: posts the ante 60
boensen1982: posts the ante 60
phpro: posts the ante 60
7SkYy: posts the ante 60
Cyan Diogenes: posts the ante 60
khaleel757: posts the ante 60
khaleel757: posts small blind 250
markudown: posts big blind 500
*** HOLE CARDS ***
Dealt to phpro [Qh Qc]
cpbf: folds
D.Leonoff: folds
boensen1982: folds
phpro: raises 500 to 1000
7SkYy: raises 1500 to 2500
Cyan Diogenes: folds
khaleel757: folds
markudown: folds
phpro: calls 1500
*** FLOP *** [Qs 5h 8d]
phpro: bets 2056
7SkYy: calls 2056
*** TURN *** [Qs 5h 8d] [4h]
phpro: bets 3064 and is all-in
7SkYy: calls 3064
*** RIVER *** [Qs 5h 8d 4h] [Kh]
*** SHOW DOWN ***
phpro: shows [Qh Qc] (three of a kind, Queens)
7SkYy: shows [As Ad] (a pair of Aces)
phpro collected 16470 from pot
*** SUMMARY ***
Total pot 16470 | Rake 0
Board [Qs 5h 8d 4h Kh]
Seat 1: markudown (big blind) folded before Flop
Seat 3: cpbf folded before Flop (didn't bet)
Seat 4: D.Leonoff folded before Flop (didn't bet)
Seat 5: boensen1982 folded before Flop (didn't bet)
Seat 6: phpro showed [Qh Qc] and won (16470) with three of a kind, Queens
Seat 7: 7SkYy showed [As Ad] and lost with a pair of Aces
Seat 8: Cyan Diogenes (button) folded before Flop (didn't bet)
Seat 9: khaleel757 (small blind) folded before Flop


*********** # 86 **************
PokerStars Hand #257046655844: Tournament #3910307458, $0.98+$0.12 USD Hold'em No Limit - Level XIII (250/500) - 2025/07/22 11:36:05 ET
Table '3910307458 12' 9-max Seat #9 is the button
Seat 1: markudown (13257 in chips)
Seat 3: cpbf (12588 in chips)
Seat 4: D.Leonoff (18105 in chips)
Seat 5: boensen1982 (18353 in chips)
Seat 6: phpro (16470 in chips)
Seat 7: 7SkYy (17534 in chips)
Seat 8: Cyan Diogenes (9475 in chips)
Seat 9: khaleel757 (12883 in chips)
markudown: posts the ante 60
cpbf: posts the ante 60
D.Leonoff: posts the ante 60
boensen1982: posts the ante 60
phpro: posts the ante 60
7SkYy: posts the ante 60
Cyan Diogenes: posts the ante 60
khaleel757: posts the ante 60
markudown: posts small blind 250
cpbf: posts big blind 500
*** HOLE CARDS ***
Dealt to phpro [Td 4c]
D.Leonoff: folds
boensen1982: folds
phpro: folds
7SkYy: raises 500 to 1000
Cyan Diogenes: folds
khaleel757: calls 1000
markudown: calls 750
cpbf: folds
*** FLOP *** [7h 3d 6s]
markudown: checks
7SkYy: checks
khaleel757: bets 1990
markudown: folds
lillw00kan13 is disconnected
7SkYy: folds
Uncalled bet (1990) returned to khaleel757
khaleel757 collected 3980 from pot
*** SUMMARY ***
Total pot 3980 | Rake 0
Board [7h 3d 6s]
Seat 1: markudown (small blind) folded on the Flop
Seat 3: cpbf (big blind) folded before Flop
Seat 4: D.Leonoff folded before Flop (didn't bet)
Seat 5: boensen1982 folded before Flop (didn't bet)
Seat 6: phpro folded before Flop (didn't bet)
Seat 7: 7SkYy folded on the Flop
Seat 8: Cyan Diogenes folded before Flop (didn't bet)
Seat 9: khaleel757 (button) collected (3980)


*********** # 87 **************
PokerStars Hand #257046667008: Tournament #3910307458, $0.98+$0.12 USD Hold'em No Limit - Level XIII (250/500) - 2025/07/22 11:37:13 ET
Table '3910307458 12' 9-max Seat #1 is the button
Seat 1: markudown (12197 in chips)
Seat 2: lillw00kan13 (2094 in chips) out of hand (moved from another table into small blind)
Seat 3: cpbf (12028 in chips)
Seat 4: D.Leonoff (18045 in chips)
Seat 5: boensen1982 (18293 in chips)
Seat 6: phpro (16410 in chips)
Seat 7: 7SkYy (16474 in chips)
Seat 8: Cyan Diogenes (9415 in chips)
Seat 9: khaleel757 (15803 in chips)
lillw00kan13 will be allowed to play after the button
markudown: posts the ante 60
cpbf: posts the ante 60
D.Leonoff: posts the ante 60
boensen1982: posts the ante 60
phpro: posts the ante 60
7SkYy: posts the ante 60
Cyan Diogenes: posts the ante 60
khaleel757: posts the ante 60
cpbf: posts small blind 250
D.Leonoff: posts big blind 500
*** HOLE CARDS ***
Dealt to phpro [5h 7s]
boensen1982: folds
phpro: folds
7SkYy: raises 500 to 1000
Cyan Diogenes: folds
khaleel757: calls 1000
markudown: folds
cpbf: folds
D.Leonoff: calls 500
*** FLOP *** [3h 6h Qh]
D.Leonoff: checks
7SkYy: checks
khaleel757: checks
*** TURN *** [3h 6h Qh] [8c]
D.Leonoff: checks
7SkYy: checks
khaleel757: checks
*** RIVER *** [3h 6h Qh 8c] [As]
D.Leonoff: checks
7SkYy: checks
khaleel757: checks
*** SHOW DOWN ***
D.Leonoff: shows [3c 5c] (a pair of Threes)
7SkYy: shows [Td Ad] (a pair of Aces)
khaleel757: mucks hand
7SkYy collected 3730 from pot
*** SUMMARY ***
Total pot 3730 | Rake 0
Board [3h 6h Qh 8c As]
Seat 1: markudown (button) folded before Flop (didn't bet)
Seat 3: cpbf (small blind) folded before Flop
Seat 4: D.Leonoff (big blind) showed [3c 5c] and lost with a pair of Threes
Seat 5: boensen1982 folded before Flop (didn't bet)
Seat 6: phpro folded before Flop (didn't bet)
Seat 7: 7SkYy showed [Td Ad] and won (3730) with a pair of Aces
Seat 8: Cyan Diogenes folded before Flop (didn't bet)
Seat 9: khaleel757 mucked [2s 2h]


*********** # 88 **************
PokerStars Hand #257046675836: Tournament #3910307458, $0.98+$0.12 USD Hold'em No Limit - Level XIII (250/500) - 2025/07/22 11:38:08 ET
Table '3910307458 12' 9-max Seat #3 is the button
Seat 1: markudown (12137 in chips)
Seat 2: lillw00kan13 (2094 in chips)
Seat 3: cpbf (11718 in chips)
Seat 4: D.Leonoff (16985 in chips)
Seat 5: boensen1982 (18233 in chips)
Seat 6: phpro (16350 in chips)
Seat 7: 7SkYy (19144 in chips)
Seat 8: Cyan Diogenes (9355 in chips)
Seat 9: khaleel757 (14743 in chips)
markudown: posts the ante 60
lillw00kan13: posts the ante 60
cpbf: posts the ante 60
D.Leonoff: posts the ante 60
boensen1982: posts the ante 60
phpro: posts the ante 60
7SkYy: posts the ante 60
Cyan Diogenes: posts the ante 60
khaleel757: posts the ante 60
D.Leonoff: posts small blind 250
boensen1982: posts big blind 500
*** HOLE CARDS ***
Dealt to phpro [4c 3c]
phpro: folds
7SkYy: folds
Cyan Diogenes: folds
khaleel757: calls 500
phpro is disconnected
phpro is disconnected
markudown: folds
lillw00kan13: folds
cpbf: raises 1250 to 1750
D.Leonoff: folds
boensen1982: folds
khaleel757: calls 1250
*** FLOP *** [3h 2c 9h]
khaleel757: checks
cpbf: bets 900
khaleel757: calls 900
*** TURN *** [3h 2c 9h] [8d]
khaleel757: checks
cpbf: checks
*** RIVER *** [3h 2c 9h 8d] [9s]
khaleel757: bets 3795
cpbf: folds
Uncalled bet (3795) returned to khaleel757
khaleel757 collected 6590 from pot
*** SUMMARY ***
Total pot 6590 | Rake 0
Board [3h 2c 9h 8d 9s]
Seat 1: markudown folded before Flop (didn't bet)
Seat 2: lillw00kan13 folded before Flop (didn't bet)
Seat 3: cpbf (button) folded on the River
Seat 4: D.Leonoff (small blind) folded before Flop
Seat 5: boensen1982 (big blind) folded before Flop
Seat 6: phpro folded before Flop (didn't bet)
Seat 7: 7SkYy folded before Flop (didn't bet)
Seat 8: Cyan Diogenes folded before Flop (didn't bet)
Seat 9: khaleel757 collected (6590)


*********** # 89 **************
PokerStars Hand #257046691963: Tournament #3910307458, $0.98+$0.12 USD Hold'em No Limit - Level XIV (300/600) - 2025/07/22 11:39:45 ET
Table '3910307458 12' 9-max Seat #4 is the button
Seat 1: markudown (12077 in chips)
Seat 2: lillw00kan13 (2034 in chips)
Seat 3: cpbf (9008 in chips)
Seat 4: D.Leonoff (16675 in chips)
Seat 5: boensen1982 (17673 in chips)
Seat 6: phpro (16290 in chips)
Seat 7: 7SkYy (19084 in chips)
Seat 8: Cyan Diogenes (9295 in chips)
Seat 9: khaleel757 (18623 in chips)
markudown: posts the ante 70
lillw00kan13: posts the ante 70
cpbf: posts the ante 70
D.Leonoff: posts the ante 70
boensen1982: posts the ante 70
phpro: posts the ante 70
7SkYy: posts the ante 70
Cyan Diogenes: posts the ante 70
khaleel757: posts the ante 70
boensen1982: posts small blind 300
phpro: posts big blind 600
*** HOLE CARDS ***
Dealt to phpro [4s Jd]
7SkYy: folds
Cyan Diogenes: folds
khaleel757: folds
markudown: folds
lillw00kan13: folds
cpbf: folds
D.Leonoff: raises 720 to 1320
boensen1982: folds
phpro: folds
Uncalled bet (720) returned to D.Leonoff
D.Leonoff collected 2130 from pot
D.Leonoff: doesn't show hand
*** SUMMARY ***
Total pot 2130 | Rake 0
Seat 1: markudown folded before Flop (didn't bet)
Seat 2: lillw00kan13 folded before Flop (didn't bet)
Seat 3: cpbf folded before Flop (didn't bet)
Seat 4: D.Leonoff (button) collected (2130)
Seat 5: boensen1982 (small blind) folded before Flop
Seat 6: phpro (big blind) folded before Flop
Seat 7: 7SkYy folded before Flop (didn't bet)
Seat 8: Cyan Diogenes folded before Flop (didn't bet)
Seat 9: khaleel757 folded before Flop (didn't bet)


*********** # 90 **************
PokerStars Hand #257046696904: Tournament #3910307458, $0.98+$0.12 USD Hold'em No Limit - Level XIV (300/600) - 2025/07/22 11:40:15 ET
Table '3910307458 12' 9-max Seat #5 is the button
Seat 1: markudown (12007 in chips)
Seat 2: lillw00kan13 (1964 in chips)
Seat 3: cpbf (8938 in chips)
Seat 4: D.Leonoff (18135 in chips)
Seat 5: boensen1982 (17303 in chips)
Seat 6: phpro (15620 in chips)
Seat 7: 7SkYy (19014 in chips)
Seat 8: Cyan Diogenes (9225 in chips)
Seat 9: khaleel757 (18553 in chips)
markudown: posts the ante 70
lillw00kan13: posts the ante 70
cpbf: posts the ante 70
D.Leonoff: posts the ante 70
boensen1982: posts the ante 70
phpro: posts the ante 70
7SkYy: posts the ante 70
Cyan Diogenes: posts the ante 70
khaleel757: posts the ante 70
phpro: posts small blind 300
7SkYy: posts big blind 600
*** HOLE CARDS ***
Dealt to phpro [As 9s]
Cyan Diogenes: folds
khaleel757: folds
markudown: folds
lillw00kan13: folds
cpbf: folds
D.Leonoff: folds
boensen1982: folds
phpro: raises 600 to 1200
7SkYy: calls 600
*** FLOP *** [Ac Jc 5c]
phpro: bets 1200
7SkYy: calls 1200
*** TURN *** [Ac Jc 5c] [4h]
phpro: bets 2115
7SkYy: calls 2115
*** RIVER *** [Ac Jc 5c 4h] [Td]
phpro: checks
7SkYy: checks
*** SHOW DOWN ***
phpro: shows [As 9s] (a pair of Aces)
7SkYy: mucks hand
phpro collected 9660 from pot
*** SUMMARY ***
Total pot 9660 | Rake 0
Board [Ac Jc 5c 4h Td]
Seat 1: markudown folded before Flop (didn't bet)
Seat 2: lillw00kan13 folded before Flop (didn't bet)
Seat 3: cpbf folded before Flop (didn't bet)
Seat 4: D.Leonoff folded before Flop (didn't bet)
Seat 5: boensen1982 (button) folded before Flop (didn't bet)
Seat 6: phpro (small blind) showed [As 9s] and won (9660) with a pair of Aces
Seat 7: 7SkYy (big blind) mucked [Js 8c]
Seat 8: Cyan Diogenes folded before Flop (didn't bet)
Seat 9: khaleel757 folded before Flop (didn't bet)


*********** # 91 **************
PokerStars Hand #257046711061: Tournament #3910307458, $0.98+$0.12 USD Hold'em No Limit - Level XIV (300/600) - 2025/07/22 11:41:42 ET
Table '3910307458 12' 9-max Seat #6 is the button
Seat 1: markudown (11937 in chips)
Seat 2: lillw00kan13 (1894 in chips)
Seat 3: cpbf (8868 in chips)
Seat 4: D.Leonoff (18065 in chips)
Seat 5: boensen1982 (17233 in chips)
Seat 6: phpro (20695 in chips)
Seat 7: 7SkYy (14429 in chips)
Seat 8: Cyan Diogenes (9155 in chips)
Seat 9: khaleel757 (18483 in chips)
markudown: posts the ante 70
lillw00kan13: posts the ante 70
cpbf: posts the ante 70
D.Leonoff: posts the ante 70
boensen1982: posts the ante 70
phpro: posts the ante 70
7SkYy: posts the ante 70
Cyan Diogenes: posts the ante 70
khaleel757: posts the ante 70
7SkYy: posts small blind 300
Cyan Diogenes: posts big blind 600
*** HOLE CARDS ***
Dealt to phpro [5s 9d]
khaleel757: folds
markudown: folds
lillw00kan13: raises 1224 to 1824 and is all-in
cpbf: calls 1824
D.Leonoff: folds
boensen1982: folds
phpro: folds
7SkYy: folds
Cyan Diogenes: folds
*** FLOP *** [2c 5d 6d]
*** TURN *** [2c 5d 6d] [8c]
*** RIVER *** [2c 5d 6d 8c] [Ah]
*** SHOW DOWN ***
lillw00kan13: shows [Jd Ks] (high card Ace)
cpbf: shows [Td Ad] (a pair of Aces)
cpbf collected 5178 from pot
lillw00kan13 finished the tournament in 58th place
*** SUMMARY ***
Total pot 5178 | Rake 0
Board [2c 5d 6d 8c Ah]
Seat 1: markudown folded before Flop (didn't bet)
Seat 2: lillw00kan13 showed [Jd Ks] and lost with high card Ace
Seat 3: cpbf showed [Td Ad] and won (5178) with a pair of Aces
Seat 4: D.Leonoff folded before Flop (didn't bet)
Seat 5: boensen1982 folded before Flop (didn't bet)
Seat 6: phpro (button) folded before Flop (didn't bet)
Seat 7: 7SkYy (small blind) folded before Flop
Seat 8: Cyan Diogenes (big blind) folded before Flop
Seat 9: khaleel757 folded before Flop (didn't bet)


*********** # 92 **************
PokerStars Hand #257046715925: Tournament #3910307458, $0.98+$0.12 USD Hold'em No Limit - Level XIV (300/600) - 2025/07/22 11:42:11 ET
Table '3910307458 12' 9-max Seat #7 is the button
Seat 1: markudown (11867 in chips)
Seat 3: cpbf (12152 in chips)
Seat 4: D.Leonoff (17995 in chips)
Seat 5: boensen1982 (17163 in chips)
Seat 6: phpro (20625 in chips)
Seat 7: 7SkYy (14059 in chips)
Seat 8: Cyan Diogenes (8485 in chips)
Seat 9: khaleel757 (18413 in chips)
markudown: posts the ante 70
cpbf: posts the ante 70
D.Leonoff: posts the ante 70
boensen1982: posts the ante 70
phpro: posts the ante 70
7SkYy: posts the ante 70
Cyan Diogenes: posts the ante 70
khaleel757: posts the ante 70
Cyan Diogenes: posts small blind 300
khaleel757: posts big blind 600
*** HOLE CARDS ***
Dealt to phpro [2d 8h]
markudown: folds
cpbf: folds
D.Leonoff: raises 660 to 1260
boensen1982: folds
phpro: folds
7SkYy: folds
Cyan Diogenes: raises 7155 to 8415 and is all-in
khaleel757: folds
D.Leonoff: folds
Uncalled bet (7155) returned to Cyan Diogenes
Cyan Diogenes collected 3680 from pot
Cyan Diogenes: doesn't show hand
*** SUMMARY ***
Total pot 3680 | Rake 0
Seat 1: markudown folded before Flop (didn't bet)
Seat 3: cpbf folded before Flop (didn't bet)
Seat 4: D.Leonoff folded before Flop
Seat 5: boensen1982 folded before Flop (didn't bet)
Seat 6: phpro folded before Flop (didn't bet)
Seat 7: 7SkYy (button) folded before Flop (didn't bet)
Seat 8: Cyan Diogenes (small blind) collected (3680)
Seat 9: khaleel757 (big blind) folded before Flop


*********** # 93 **************
PokerStars Hand #257046722739: Tournament #3910307458, $0.98+$0.12 USD Hold'em No Limit - Level XIV (300/600) - 2025/07/22 11:42:53 ET
Table '3910307458 12' 9-max Seat #8 is the button
Seat 1: markudown (11797 in chips)
Seat 3: cpbf (12082 in chips)
Seat 4: D.Leonoff (16665 in chips)
Seat 5: boensen1982 (17093 in chips)
Seat 6: phpro (20555 in chips)
Seat 7: 7SkYy (13989 in chips)
Seat 8: Cyan Diogenes (10835 in chips)
Seat 9: khaleel757 (17743 in chips)
markudown: posts the ante 70
cpbf: posts the ante 70
D.Leonoff: posts the ante 70
boensen1982: posts the ante 70
phpro: posts the ante 70
7SkYy: posts the ante 70
Cyan Diogenes: posts the ante 70
khaleel757: posts the ante 70
khaleel757: posts small blind 300
markudown: posts big blind 600
*** HOLE CARDS ***
Dealt to phpro [As 6s]
cpbf: folds
D.Leonoff: folds
boensen1982: raises 660 to 1260
phpro: folds
7SkYy: folds
Cyan Diogenes: folds
khaleel757: calls 960
markudown: folds
*** FLOP *** [2c Qh Ts]
khaleel757: checks
boensen1982: bets 1500
khaleel757: folds
Uncalled bet (1500) returned to boensen1982
boensen1982 collected 3680 from pot
boensen1982: doesn't show hand
*** SUMMARY ***
Total pot 3680 | Rake 0
Board [2c Qh Ts]
Seat 1: markudown (big blind) folded before Flop
Seat 3: cpbf folded before Flop (didn't bet)
Seat 4: D.Leonoff folded before Flop (didn't bet)
Seat 5: boensen1982 collected (3680)
Seat 6: phpro folded before Flop (didn't bet)
Seat 7: 7SkYy folded before Flop (didn't bet)
Seat 8: Cyan Diogenes (button) folded before Flop (didn't bet)
Seat 9: khaleel757 (small blind) folded on the Flop


*********** # 94 **************
PokerStars Hand #257046727510: Tournament #3910307458, $0.98+$0.12 USD Hold'em No Limit - Level XIV (300/600) - 2025/07/22 11:43:22 ET
Table '3910307458 12' 9-max Seat #9 is the button
Seat 1: markudown (11127 in chips)
Seat 3: cpbf (12012 in chips)
Seat 4: D.Leonoff (16595 in chips)
Seat 5: boensen1982 (19443 in chips)
Seat 6: phpro (20485 in chips)
Seat 7: 7SkYy (13919 in chips)
Seat 8: Cyan Diogenes (10765 in chips)
Seat 9: khaleel757 (16413 in chips)
markudown: posts the ante 70
cpbf: posts the ante 70
D.Leonoff: posts the ante 70
boensen1982: posts the ante 70
phpro: posts the ante 70
7SkYy: posts the ante 70
Cyan Diogenes: posts the ante 70
khaleel757: posts the ante 70
markudown: posts small blind 300
cpbf: posts big blind 600
*** HOLE CARDS ***
Dealt to phpro [6c 9h]
D.Leonoff: folds
boensen1982: folds
phpro: folds
7SkYy: folds
Cyan Diogenes: folds
khaleel757: folds
dimasiktuta is disconnected
markudown: calls 300
cpbf: raises 1500 to 2100
markudown: calls 1500
*** FLOP *** [4d Td 2c]
markudown: checks
cpbf: bets 9842 and is all-in
markudown: folds
Uncalled bet (9842) returned to cpbf
cpbf collected 4760 from pot
cpbf: doesn't show hand
*** SUMMARY ***
Total pot 4760 | Rake 0
Board [4d Td 2c]
Seat 1: markudown (small blind) folded on the Flop
Seat 3: cpbf (big blind) collected (4760)
Seat 4: D.Leonoff folded before Flop (didn't bet)
Seat 5: boensen1982 folded before Flop (didn't bet)
Seat 6: phpro folded before Flop (didn't bet)
Seat 7: 7SkYy folded before Flop (didn't bet)
Seat 8: Cyan Diogenes folded before Flop (didn't bet)
Seat 9: khaleel757 (button) folded before Flop (didn't bet)


*********** # 95 **************
PokerStars Hand #257046743816: Tournament #3910307458, $0.98+$0.12 USD Hold'em No Limit - Level XIV (300/600) - 2025/07/22 11:45:01 ET
Table '3910307458 12' 9-max Seat #1 is the button
Seat 1: markudown (8957 in chips)
Seat 2: dimasiktuta (50634 in chips) out of hand (moved from another table into small blind)
Seat 3: cpbf (14602 in chips)
Seat 4: D.Leonoff (16525 in chips)
Seat 5: boensen1982 (19373 in chips)
Seat 6: phpro (20415 in chips)
Seat 7: 7SkYy (13849 in chips)
Seat 8: Cyan Diogenes (10695 in chips)
Seat 9: khaleel757 (16343 in chips)
dimasiktuta will be allowed to play after the button
markudown: posts the ante 70
cpbf: posts the ante 70
D.Leonoff: posts the ante 70
boensen1982: posts the ante 70
phpro: posts the ante 70
7SkYy: posts the ante 70
Cyan Diogenes: posts the ante 70
khaleel757: posts the ante 70
cpbf: posts small blind 300
D.Leonoff: posts big blind 600
*** HOLE CARDS ***
Dealt to phpro [9d 7c]
boensen1982: calls 600
phpro: folds
7SkYy: folds
Cyan Diogenes: folds
khaleel757: raises 1200 to 1800
markudown: folds
cpbf: folds
D.Leonoff: calls 1200
boensen1982: folds
*** FLOP *** [7s Qh 2d]
D.Leonoff: checks
khaleel757: bets 1800
D.Leonoff: calls 1800
*** TURN *** [7s Qh 2d] [4h]
D.Leonoff: checks
khaleel757: bets 2530
D.Leonoff: calls 2530
*** RIVER *** [7s Qh 2d 4h] [4s]
D.Leonoff: bets 10325 and is all-in
khaleel757 has timed out
khaleel757: folds
khaleel757 is sitting out
Uncalled bet (10325) returned to D.Leonoff
D.Leonoff collected 13720 from pot
khaleel757 has returned
D.Leonoff: doesn't show hand
*** SUMMARY ***
Total pot 13720 | Rake 0
Board [7s Qh 2d 4h 4s]
Seat 1: markudown (button) folded before Flop (didn't bet)
Seat 3: cpbf (small blind) folded before Flop
Seat 4: D.Leonoff (big blind) collected (13720)
Seat 5: boensen1982 folded before Flop
Seat 6: phpro folded before Flop (didn't bet)
Seat 7: 7SkYy folded before Flop (didn't bet)
Seat 8: Cyan Diogenes folded before Flop (didn't bet)
Seat 9: khaleel757 folded on the River


*********** # 96 **************
PokerStars Hand #257046758561: Tournament #3910307458, $0.98+$0.12 USD Hold'em No Limit - Level XIV (300/600) - 2025/07/22 11:46:31 ET
Table '3910307458 12' 9-max Seat #3 is the button
Seat 1: markudown (8887 in chips)
Seat 2: dimasiktuta (50634 in chips)
Seat 3: cpbf (14232 in chips)
Seat 4: D.Leonoff (24045 in chips)
Seat 5: boensen1982 (18703 in chips)
Seat 6: phpro (20345 in chips)
Seat 7: 7SkYy (13779 in chips)
Seat 8: Cyan Diogenes (10625 in chips)
Seat 9: khaleel757 (10143 in chips)
markudown: posts the ante 70
dimasiktuta: posts the ante 70
cpbf: posts the ante 70
D.Leonoff: posts the ante 70
boensen1982: posts the ante 70
phpro: posts the ante 70
7SkYy: posts the ante 70
Cyan Diogenes: posts the ante 70
khaleel757: posts the ante 70
D.Leonoff: posts small blind 300
boensen1982: posts big blind 600
*** HOLE CARDS ***
Dealt to phpro [Ks Qh]
phpro: folds
7SkYy: folds
Cyan Diogenes: folds
khaleel757: folds
markudown: folds
dimasiktuta: raises 600 to 1200
cpbf: folds
D.Leonoff: folds
boensen1982: folds
Uncalled bet (600) returned to dimasiktuta
dimasiktuta collected 2130 from pot
dimasiktuta: doesn't show hand
*** SUMMARY ***
Total pot 2130 | Rake 0
Seat 1: markudown folded before Flop (didn't bet)
Seat 2: dimasiktuta collected (2130)
Seat 3: cpbf (button) folded before Flop (didn't bet)
Seat 4: D.Leonoff (small blind) folded before Flop
Seat 5: boensen1982 (big blind) folded before Flop
Seat 6: phpro folded before Flop (didn't bet)
Seat 7: 7SkYy folded before Flop (didn't bet)
Seat 8: Cyan Diogenes folded before Flop (didn't bet)
Seat 9: khaleel757 folded before Flop (didn't bet)


*********** # 97 **************
PokerStars Hand #257046767956: Tournament #3910307458, $0.98+$0.12 USD Hold'em No Limit - Level XIV (300/600) - 2025/07/22 11:47:28 ET
Table '3910307458 12' 9-max Seat #4 is the button
Seat 1: markudown (8817 in chips)
Seat 2: dimasiktuta (52094 in chips)
Seat 3: cpbf (14162 in chips)
Seat 4: D.Leonoff (23675 in chips)
Seat 5: boensen1982 (18033 in chips)
Seat 6: phpro (20275 in chips)
Seat 7: 7SkYy (13709 in chips)
Seat 8: Cyan Diogenes (10555 in chips)
Seat 9: khaleel757 (10073 in chips)
markudown: posts the ante 70
dimasiktuta: posts the ante 70
cpbf: posts the ante 70
D.Leonoff: posts the ante 70
boensen1982: posts the ante 70
phpro: posts the ante 70
7SkYy: posts the ante 70
Cyan Diogenes: posts the ante 70
khaleel757: posts the ante 70
boensen1982: posts small blind 300
phpro: posts big blind 600
*** HOLE CARDS ***
Dealt to phpro [Qc Jh]
7SkYy: folds
Cyan Diogenes: folds
khaleel757: calls 600
markudown: folds
dimasiktuta: folds
cpbf: folds
D.Leonoff: folds
boensen1982: folds
phpro: checks
*** FLOP *** [Qs 8c 6s]
phpro: bets 1065
khaleel757: calls 1065
*** TURN *** [Qs 8c 6s] [Ah]
phpro: checks
khaleel757: bets 2130
phpro: folds
Uncalled bet (2130) returned to khaleel757
khaleel757 collected 4260 from pot
*** SUMMARY ***
Total pot 4260 | Rake 0
Board [Qs 8c 6s Ah]
Seat 1: markudown folded before Flop (didn't bet)
Seat 2: dimasiktuta folded before Flop (didn't bet)
Seat 3: cpbf folded before Flop (didn't bet)
Seat 4: D.Leonoff (button) folded before Flop (didn't bet)
Seat 5: boensen1982 (small blind) folded before Flop
Seat 6: phpro (big blind) folded on the Turn
Seat 7: 7SkYy folded before Flop (didn't bet)
Seat 8: Cyan Diogenes folded before Flop (didn't bet)
Seat 9: khaleel757 collected (4260)


*********** # 98 **************
PokerStars Hand #257046777273: Tournament #3910307458, $0.98+$0.12 USD Hold'em No Limit - Level XIV (300/600) - 2025/07/22 11:48:23 ET
Table '3910307458 12' 9-max Seat #5 is the button
Seat 1: markudown (8747 in chips)
Seat 2: dimasiktuta (52024 in chips)
Seat 3: cpbf (14092 in chips)
Seat 4: D.Leonoff (23605 in chips)
Seat 5: boensen1982 (17663 in chips)
Seat 6: phpro (18540 in chips)
Seat 7: 7SkYy (13639 in chips)
Seat 8: Cyan Diogenes (10485 in chips)
Seat 9: khaleel757 (12598 in chips)
markudown: posts the ante 70
dimasiktuta: posts the ante 70
cpbf: posts the ante 70
D.Leonoff: posts the ante 70
boensen1982: posts the ante 70
phpro: posts the ante 70
7SkYy: posts the ante 70
Cyan Diogenes: posts the ante 70
khaleel757: posts the ante 70
phpro: posts small blind 300
7SkYy: posts big blind 600
*** HOLE CARDS ***
Dealt to phpro [7s 2d]
Cyan Diogenes: folds
khaleel757: calls 600
markudown: folds
dimasiktuta: folds
cpbf: folds
D.Leonoff: folds
boensen1982: folds
phpro: folds
7SkYy: checks
*** FLOP *** [Kc 2s Qh]
7SkYy: checks
khaleel757: checks
*** TURN *** [Kc 2s Qh] [3s]
7SkYy: checks
khaleel757: checks
*** RIVER *** [Kc 2s Qh 3s] [6c]
7SkYy: checks
khaleel757: checks
*** SHOW DOWN ***
7SkYy: shows [Ad Tc] (high card Ace)
khaleel757: mucks hand
7SkYy collected 2130 from pot
*** SUMMARY ***
Total pot 2130 | Rake 0
Board [Kc 2s Qh 3s 6c]
Seat 1: markudown folded before Flop (didn't bet)
Seat 2: dimasiktuta folded before Flop (didn't bet)
Seat 3: cpbf folded before Flop (didn't bet)
Seat 4: D.Leonoff folded before Flop (didn't bet)
Seat 5: boensen1982 (button) folded before Flop (didn't bet)
Seat 6: phpro (small blind) folded before Flop
Seat 7: 7SkYy (big blind) showed [Ad Tc] and won (2130) with high card Ace
Seat 8: Cyan Diogenes folded before Flop (didn't bet)
Seat 9: khaleel757 mucked [As 5h]


*********** # 99 **************
PokerStars Hand #257046788668: Tournament #3910307458, $0.98+$0.12 USD Hold'em No Limit - Level XV (350/700) - 2025/07/22 11:49:32 ET
Table '3910307458 12' 9-max Seat #6 is the button
Seat 1: markudown (8677 in chips)
Seat 2: dimasiktuta (51954 in chips)
Seat 3: cpbf (14022 in chips)
Seat 4: D.Leonoff (23535 in chips)
Seat 5: boensen1982 (17593 in chips)
Seat 6: phpro (18170 in chips)
Seat 7: 7SkYy (15099 in chips)
Seat 8: Cyan Diogenes (10415 in chips)
Seat 9: khaleel757 (11928 in chips)
markudown: posts the ante 85
dimasiktuta: posts the ante 85
cpbf: posts the ante 85
D.Leonoff: posts the ante 85
boensen1982: posts the ante 85
phpro: posts the ante 85
7SkYy: posts the ante 85
Cyan Diogenes: posts the ante 85
khaleel757: posts the ante 85
7SkYy: posts small blind 350
Cyan Diogenes: posts big blind 700
*** HOLE CARDS ***
Dealt to phpro [8d 5c]
khaleel757: calls 700
markudown: folds
dimasiktuta: folds
cpbf: folds
D.Leonoff: folds
boensen1982: folds
phpro: folds
7SkYy: folds
Cyan Diogenes: checks
*** FLOP *** [4c Qh Jh]
Cyan Diogenes: checks
khaleel757: checks
*** TURN *** [4c Qh Jh] [5d]
Cyan Diogenes: bets 1258
khaleel757: folds
Uncalled bet (1258) returned to Cyan Diogenes
Cyan Diogenes collected 2515 from pot
Cyan Diogenes: doesn't show hand
*** SUMMARY ***
Total pot 2515 | Rake 0
Board [4c Qh Jh 5d]
Seat 1: markudown folded before Flop (didn't bet)
Seat 2: dimasiktuta folded before Flop (didn't bet)
Seat 3: cpbf folded before Flop (didn't bet)
Seat 4: D.Leonoff folded before Flop (didn't bet)
Seat 5: boensen1982 folded before Flop (didn't bet)
Seat 6: phpro (button) folded before Flop (didn't bet)
Seat 7: 7SkYy (small blind) folded before Flop
Seat 8: Cyan Diogenes (big blind) collected (2515)
Seat 9: khaleel757 folded on the Turn


*********** # 100 **************
PokerStars Hand #257046808146: Tournament #3910307458, $0.98+$0.12 USD Hold'em No Limit - Level XV (350/700) - 2025/07/22 11:51:28 ET
Table '3910307458 12' 9-max Seat #7 is the button
Seat 1: markudown (8592 in chips)
Seat 2: dimasiktuta (51869 in chips)
Seat 3: cpbf (13937 in chips) is sitting out
Seat 4: D.Leonoff (23450 in chips)
Seat 5: boensen1982 (17508 in chips)
Seat 6: phpro (18085 in chips)
Seat 7: 7SkYy (14664 in chips)
Seat 8: Cyan Diogenes (12145 in chips)
Seat 9: khaleel757 (11143 in chips)
markudown: posts the ante 85
dimasiktuta: posts the ante 85
cpbf: posts the ante 85
D.Leonoff: posts the ante 85
boensen1982: posts the ante 85
phpro: posts the ante 85
7SkYy: posts the ante 85
Cyan Diogenes: posts the ante 85
khaleel757: posts the ante 85
Cyan Diogenes: posts small blind 350
khaleel757: posts big blind 700
*** HOLE CARDS ***
Dealt to phpro [9d Jc]
markudown: calls 700
dimasiktuta: folds
cpbf: folds
D.Leonoff: folds
boensen1982: raises 1050 to 1750
phpro: folds
7SkYy: folds
Cyan Diogenes: folds
khaleel757: calls 1050
markudown: calls 1050
*** FLOP *** [3s As Kc]
khaleel757: bets 9308 and is all-in
markudown: calls 6757 and is all-in
boensen1982: folds
Uncalled bet (2551) returned to khaleel757
*** TURN *** [3s As Kc] [5s]
*** RIVER *** [3s As Kc 5s] [2c]
*** SHOW DOWN ***
khaleel757: shows [2s 4s] (a straight flush, Ace to Five)
markudown: shows [Qc Ad] (a pair of Aces)
khaleel757 collected 19879 from pot
markudown finished the tournament in 54th place
*** SUMMARY ***
Total pot 19879 | Rake 0
Board [3s As Kc 5s 2c]
Seat 1: markudown showed [Qc Ad] and lost with a pair of Aces
Seat 2: dimasiktuta folded before Flop (didn't bet)
Seat 3: cpbf folded before Flop (didn't bet)
Seat 4: D.Leonoff folded before Flop (didn't bet)
Seat 5: boensen1982 folded on the Flop
Seat 6: phpro folded before Flop (didn't bet)
Seat 7: 7SkYy (button) folded before Flop (didn't bet)
Seat 8: Cyan Diogenes (small blind) folded before Flop
Seat 9: khaleel757 (big blind) showed [2s 4s] and won (19879) with a straight flush, Ace to Five


*********** # 101 **************
PokerStars Hand #257046818993: Tournament #3910307458, $0.98+$0.12 USD Hold'em No Limit - Level XV (350/700) - 2025/07/22 11:52:32 ET
Table '3910307458 12' 9-max Seat #8 is the button
Seat 2: dimasiktuta (51784 in chips)
Seat 3: cpbf (13852 in chips) is sitting out
Seat 4: D.Leonoff (23365 in chips)
Seat 5: boensen1982 (15673 in chips)
Seat 6: phpro (18000 in chips)
Seat 7: 7SkYy (14579 in chips)
Seat 8: Cyan Diogenes (11710 in chips)
Seat 9: khaleel757 (22430 in chips)
dimasiktuta: posts the ante 85
cpbf: posts the ante 85
D.Leonoff: posts the ante 85
boensen1982: posts the ante 85
phpro: posts the ante 85
7SkYy: posts the ante 85
Cyan Diogenes: posts the ante 85
khaleel757: posts the ante 85
khaleel757: posts small blind 350
dimasiktuta: posts big blind 700
*** HOLE CARDS ***
Dealt to phpro [3c 6s]
cpbf: folds
D.Leonoff: folds
boensen1982: folds
phpro: folds
7SkYy: folds
Cyan Diogenes: folds
khaleel757: calls 350
dimasiktuta: raises 1750 to 2450
khaleel757: calls 1750
*** FLOP *** [4c 2c 8s]
khaleel757: bets 2790
dimasiktuta: folds
Uncalled bet (2790) returned to khaleel757
khaleel757 collected 5580 from pot
*** SUMMARY ***
Total pot 5580 | Rake 0
Board [4c 2c 8s]
Seat 2: dimasiktuta (big blind) folded on the Flop
Seat 3: cpbf folded before Flop (didn't bet)
Seat 4: D.Leonoff folded before Flop (didn't bet)
Seat 5: boensen1982 folded before Flop (didn't bet)
Seat 6: phpro folded before Flop (didn't bet)
Seat 7: 7SkYy folded before Flop (didn't bet)
Seat 8: Cyan Diogenes (button) folded before Flop (didn't bet)
Seat 9: khaleel757 (small blind) collected (5580)


*********** # 102 **************
PokerStars Hand #257046826750: Tournament #3910307458, $0.98+$0.12 USD Hold'em No Limit - Level XV (350/700) - 2025/07/22 11:53:18 ET
Table '3910307458 12' 9-max Seat #9 is the button
Seat 2: dimasiktuta (49249 in chips)
Seat 3: cpbf (13767 in chips) is sitting out
Seat 4: D.Leonoff (23280 in chips)
Seat 5: boensen1982 (15588 in chips)
Seat 6: phpro (17915 in chips)
Seat 7: 7SkYy (14494 in chips)
Seat 8: Cyan Diogenes (11625 in chips)
Seat 9: khaleel757 (25475 in chips)
dimasiktuta: posts the ante 85
cpbf: posts the ante 85
D.Leonoff: posts the ante 85
boensen1982: posts the ante 85
phpro: posts the ante 85
7SkYy: posts the ante 85
Cyan Diogenes: posts the ante 85
khaleel757: posts the ante 85
dimasiktuta: posts small blind 350
cpbf: posts big blind 700
*** HOLE CARDS ***
Dealt to phpro [4c 9h]
D.Leonoff: folds
boensen1982: raises 770 to 1470
phpro: folds
7SkYy: folds
Cyan Diogenes: folds
khaleel757: folds
dimasiktuta: calls 1120
cpbf: folds
*** FLOP *** [8d 3s 4h]
dimasiktuta: checks
boensen1982: bets 2100
dimasiktuta: folds
Uncalled bet (2100) returned to boensen1982
boensen1982 collected 4320 from pot
boensen1982: doesn't show hand
*** SUMMARY ***
Total pot 4320 | Rake 0
Board [8d 3s 4h]
Seat 2: dimasiktuta (small blind) folded on the Flop
Seat 3: cpbf (big blind) folded before Flop
Seat 4: D.Leonoff folded before Flop (didn't bet)
Seat 5: boensen1982 collected (4320)
Seat 6: phpro folded before Flop (didn't bet)
Seat 7: 7SkYy folded before Flop (didn't bet)
Seat 8: Cyan Diogenes folded before Flop (didn't bet)
Seat 9: khaleel757 (button) folded before Flop (didn't bet)


*********** # 103 **************
PokerStars Hand #257046832132: Tournament #3910307458, $0.98+$0.12 USD Hold'em No Limit - Level XV (350/700) - 2025/07/22 11:53:51 ET
Table '3910307458 12' 9-max Seat #2 is the button
Seat 2: dimasiktuta (47694 in chips)
Seat 3: cpbf (12982 in chips) is sitting out
Seat 4: D.Leonoff (23195 in chips)
Seat 5: boensen1982 (18353 in chips)
Seat 6: phpro (17830 in chips)
Seat 7: 7SkYy (14409 in chips)
Seat 8: Cyan Diogenes (11540 in chips)
Seat 9: khaleel757 (25390 in chips)
dimasiktuta: posts the ante 85
cpbf: posts the ante 85
D.Leonoff: posts the ante 85
boensen1982: posts the ante 85
phpro: posts the ante 85
7SkYy: posts the ante 85
Cyan Diogenes: posts the ante 85
khaleel757: posts the ante 85
cpbf: posts small blind 350
D.Leonoff: posts big blind 700
*** HOLE CARDS ***
Dealt to phpro [Th 4h]
boensen1982: raises 700 to 1400
phpro: folds
7SkYy: folds
Cyan Diogenes: folds
khaleel757: calls 1400
dimasiktuta: folds
cpbf: folds
D.Leonoff: calls 700
*** FLOP *** [Ts 7s Kd]
D.Leonoff: checks
boensen1982: bets 3452
khaleel757: calls 3452
D.Leonoff: folds
*** TURN *** [Ts 7s Kd] [Qs]
boensen1982: checks
khaleel757: bets 3967
boensen1982: calls 3967
*** RIVER *** [Ts 7s Kd Qs] [3s]
boensen1982: bets 9449 and is all-in
khaleel757: folds
Uncalled bet (9449) returned to boensen1982
boensen1982 collected 20068 from pot
boensen1982: doesn't show hand
*** SUMMARY ***
Total pot 20068 | Rake 0
Board [Ts 7s Kd Qs 3s]
Seat 2: dimasiktuta (button) folded before Flop (didn't bet)
Seat 3: cpbf (small blind) folded before Flop
Seat 4: D.Leonoff (big blind) folded on the Flop
Seat 5: boensen1982 collected (20068)
Seat 6: phpro folded before Flop (didn't bet)
Seat 7: 7SkYy folded before Flop (didn't bet)
Seat 8: Cyan Diogenes folded before Flop (didn't bet)
Seat 9: khaleel757 folded on the River


*********** # 104 **************
PokerStars Hand #257046844580: Tournament #3910307458, $0.98+$0.12 USD Hold'em No Limit - Level XV (350/700) - 2025/07/22 11:55:05 ET
Table '3910307458 12' 9-max Seat #3 is the button
Seat 2: dimasiktuta (47609 in chips)
Seat 3: cpbf (12547 in chips) is sitting out
Seat 4: D.Leonoff (21710 in chips)
Seat 5: boensen1982 (29517 in chips)
Seat 6: phpro (17745 in chips)
Seat 7: 7SkYy (14324 in chips)
Seat 8: Cyan Diogenes (11455 in chips)
Seat 9: khaleel757 (16486 in chips)
dimasiktuta: posts the ante 85
cpbf: posts the ante 85
D.Leonoff: posts the ante 85
boensen1982: posts the ante 85
phpro: posts the ante 85
7SkYy: posts the ante 85
Cyan Diogenes: posts the ante 85
khaleel757: posts the ante 85
D.Leonoff: posts small blind 350
boensen1982: posts big blind 700
*** HOLE CARDS ***
Dealt to phpro [Tc 9h]
phpro: folds
7SkYy: raises 700 to 1400
Cyan Diogenes: folds
khaleel757: calls 1400
dimasiktuta: raises 3500 to 4900
cpbf: folds
D.Leonoff: folds
boensen1982: folds
7SkYy: folds
khaleel757: calls 3500
*** FLOP *** [7c Ts 6c]
khaleel757: bets 6465
dimasiktuta: raises 21981 to 28446
khaleel757: calls 5036 and is all-in
Uncalled bet (16945) returned to dimasiktuta
*** TURN *** [7c Ts 6c] [Th]
*** RIVER *** [7c Ts 6c Th] [3d]
ericpoker194 is disconnected
*** SHOW DOWN ***
khaleel757: shows [Qd 5d] (a pair of Tens)
dimasiktuta: shows [Ah Td] (three of a kind, Tens)
dimasiktuta collected 35932 from pot
khaleel757 finished the tournament in 45th place and received $1.75.
*** SUMMARY ***
Total pot 35932 | Rake 0
Board [7c Ts 6c Th 3d]
Seat 2: dimasiktuta showed [Ah Td] and won (35932) with three of a kind, Tens
Seat 3: cpbf (button) folded before Flop (didn't bet)
Seat 4: D.Leonoff (small blind) folded before Flop
Seat 5: boensen1982 (big blind) folded before Flop
Seat 6: phpro folded before Flop (didn't bet)
Seat 7: 7SkYy folded before Flop
Seat 8: Cyan Diogenes folded before Flop (didn't bet)
Seat 9: khaleel757 showed [Qd 5d] and lost with a pair of Tens


*********** # 105 **************
PokerStars Hand #257046889588: Tournament #3910307458, $0.98+$0.12 USD Hold'em No Limit - Level XV (350/700) - 2025/07/22 12:00:49 ET
Table '3910307458 12' 9-max Seat #4 is the button
Seat 1: ericpoker194 (18961 in chips)
Seat 2: dimasiktuta (67055 in chips)
Seat 3: cpbf (12462 in chips)
Seat 4: D.Leonoff (21275 in chips)
Seat 5: boensen1982 (28732 in chips)
Seat 6: phpro (17660 in chips)
Seat 7: 7SkYy (12839 in chips)
Seat 8: Cyan Diogenes (11370 in chips)
ericpoker194: posts the ante 85
dimasiktuta: posts the ante 85
cpbf: posts the ante 85
D.Leonoff: posts the ante 85
boensen1982: posts the ante 85
phpro: posts the ante 85
7SkYy: posts the ante 85
Cyan Diogenes: posts the ante 85
boensen1982: posts small blind 350
phpro: posts big blind 700
*** HOLE CARDS ***
Dealt to phpro [Kh 8c]
7SkYy has timed out
7SkYy: folds
7SkYy is sitting out
Cyan Diogenes: folds
ericpoker194: raises 700 to 1400
dimasiktuta: raises 3500 to 4900
cpbf: folds
D.Leonoff: folds
boensen1982: folds
phpro: folds
ericpoker194: folds
Uncalled bet (3500) returned to dimasiktuta
7SkYy has returned
dimasiktuta collected 4530 from pot
dimasiktuta: doesn't show hand
*** SUMMARY ***
Total pot 4530 | Rake 0
Seat 1: ericpoker194 folded before Flop
Seat 2: dimasiktuta collected (4530)
Seat 3: cpbf folded before Flop (didn't bet)
Seat 4: D.Leonoff (button) folded before Flop (didn't bet)
Seat 5: boensen1982 (small blind) folded before Flop
Seat 6: phpro (big blind) folded before Flop
Seat 7: 7SkYy folded before Flop (didn't bet)
Seat 8: Cyan Diogenes folded before Flop (didn't bet)


*********** # 106 **************
PokerStars Hand #257046899080: Tournament #3910307458, $0.98+$0.12 USD Hold'em No Limit - Level XV (350/700) - 2025/07/22 12:01:49 ET
Table '3910307458 12' 9-max Seat #5 is the button
Seat 1: ericpoker194 (17476 in chips)
Seat 2: dimasiktuta (70100 in chips)
Seat 3: cpbf (12377 in chips)
Seat 4: D.Leonoff (21190 in chips)
Seat 5: boensen1982 (28297 in chips)
Seat 6: phpro (16875 in chips)
Seat 7: 7SkYy (12754 in chips)
Seat 8: Cyan Diogenes (11285 in chips)
ericpoker194: posts the ante 85
dimasiktuta: posts the ante 85
cpbf: posts the ante 85
D.Leonoff: posts the ante 85
boensen1982: posts the ante 85
phpro: posts the ante 85
7SkYy: posts the ante 85
Cyan Diogenes: posts the ante 85
phpro: posts small blind 350
7SkYy: posts big blind 700
*** HOLE CARDS ***
Dealt to phpro [4d 6c]
Cyan Diogenes: folds
ericpoker194: folds
dimasiktuta: raises 700 to 1400
cpbf: folds
D.Leonoff: raises 3150 to 4550
boensen1982: folds
phpro: folds
7SkYy: folds
dimasiktuta: folds
Uncalled bet (3150) returned to D.Leonoff
D.Leonoff collected 4530 from pot
D.Leonoff: doesn't show hand
*** SUMMARY ***
Total pot 4530 | Rake 0
Seat 1: ericpoker194 folded before Flop (didn't bet)
Seat 2: dimasiktuta folded before Flop
Seat 3: cpbf folded before Flop (didn't bet)
Seat 4: D.Leonoff collected (4530)
Seat 5: boensen1982 (button) folded before Flop (didn't bet)
Seat 6: phpro (small blind) folded before Flop
Seat 7: 7SkYy (big blind) folded before Flop
Seat 8: Cyan Diogenes folded before Flop (didn't bet)


*********** # 107 **************
PokerStars Hand #257046905511: Tournament #3910307458, $0.98+$0.12 USD Hold'em No Limit - Level XV (350/700) - 2025/07/22 12:02:28 ET
Table '3910307458 12' 9-max Seat #6 is the button
Seat 1: ericpoker194 (17391 in chips)
Seat 2: dimasiktuta (68615 in chips)
Seat 3: cpbf (12292 in chips)
Seat 4: D.Leonoff (24235 in chips)
Seat 5: boensen1982 (28212 in chips)
Seat 6: phpro (16440 in chips)
Seat 7: 7SkYy (11969 in chips)
Seat 8: Cyan Diogenes (11200 in chips)
ericpoker194: posts the ante 85
dimasiktuta: posts the ante 85
cpbf: posts the ante 85
D.Leonoff: posts the ante 85
boensen1982: posts the ante 85
phpro: posts the ante 85
7SkYy: posts the ante 85
Cyan Diogenes: posts the ante 85
7SkYy: posts small blind 350
Cyan Diogenes: posts big blind 700
*** HOLE CARDS ***
Dealt to phpro [5d 7h]
ericpoker194: folds
dimasiktuta: folds
cpbf: folds
D.Leonoff: folds
boensen1982: raises 700 to 1400
phpro: folds
7SkYy: raises 10484 to 11884 and is all-in
Cyan Diogenes: folds
boensen1982: folds
Uncalled bet (10484) returned to 7SkYy
7SkYy collected 4180 from pot
7SkYy: doesn't show hand
*** SUMMARY ***
Total pot 4180 | Rake 0
Seat 1: ericpoker194 folded before Flop (didn't bet)
Seat 2: dimasiktuta folded before Flop (didn't bet)
Seat 3: cpbf folded before Flop (didn't bet)
Seat 4: D.Leonoff folded before Flop (didn't bet)
Seat 5: boensen1982 folded before Flop
Seat 6: phpro (button) folded before Flop (didn't bet)
Seat 7: 7SkYy (small blind) collected (4180)
Seat 8: Cyan Diogenes (big blind) folded before Flop


*********** # 108 **************
PokerStars Hand #257046911463: Tournament #3910307458, $0.98+$0.12 USD Hold'em No Limit - Level XV (350/700) - 2025/07/22 12:03:04 ET
Table '3910307458 12' 9-max Seat #7 is the button
Seat 1: ericpoker194 (17306 in chips)
Seat 2: dimasiktuta (68530 in chips)
Seat 3: cpbf (12207 in chips)
Seat 4: D.Leonoff (24150 in chips)
Seat 5: boensen1982 (26727 in chips)
Seat 6: phpro (16355 in chips)
Seat 7: 7SkYy (14664 in chips)
Seat 8: Cyan Diogenes (10415 in chips)
ericpoker194: posts the ante 85
dimasiktuta: posts the ante 85
cpbf: posts the ante 85
D.Leonoff: posts the ante 85
boensen1982: posts the ante 85
phpro: posts the ante 85
7SkYy: posts the ante 85
Cyan Diogenes: posts the ante 85
Cyan Diogenes: posts small blind 350
ericpoker194: posts big blind 700
*** HOLE CARDS ***
Dealt to phpro [Ad 2d]
dimasiktuta: folds
cpbf: folds
D.Leonoff: folds
boensen1982: raises 700 to 1400
phpro: folds
7SkYy: raises 13179 to 14579 and is all-in
Cyan Diogenes: folds
ericpoker194: folds
boensen1982: calls 13179
*** FLOP *** [5h 6d 6h]
*** TURN *** [5h 6d 6h] [9s]
*** RIVER *** [5h 6d 6h 9s] [As]
*** SHOW DOWN ***
boensen1982: shows [Ah Qd] (two pair, Aces and Sixes)
7SkYy: shows [Kc Ac] (two pair, Aces and Sixes - King kicker)
7SkYy collected 30888 from pot
*** SUMMARY ***
Total pot 30888 | Rake 0
Board [5h 6d 6h 9s As]
Seat 1: ericpoker194 (big blind) folded before Flop
Seat 2: dimasiktuta folded before Flop (didn't bet)
Seat 3: cpbf folded before Flop (didn't bet)
Seat 4: D.Leonoff folded before Flop (didn't bet)
Seat 5: boensen1982 showed [Ah Qd] and lost with two pair, Aces and Sixes
Seat 6: phpro folded before Flop (didn't bet)
Seat 7: 7SkYy (button) showed [Kc Ac] and won (30888) with two pair, Aces and Sixes
Seat 8: Cyan Diogenes (small blind) folded before Flop


*********** # 109 **************
PokerStars Hand #257046918596: Tournament #3910307458, $0.98+$0.12 USD Hold'em No Limit - Level XV (350/700) - 2025/07/22 12:03:46 ET
Table '3910307458 12' 9-max Seat #8 is the button
Seat 1: ericpoker194 (16521 in chips)
Seat 2: dimasiktuta (68445 in chips)
Seat 3: cpbf (12122 in chips)
Seat 4: D.Leonoff (24065 in chips)
Seat 5: boensen1982 (12063 in chips)
Seat 6: phpro (16270 in chips)
Seat 7: 7SkYy (30888 in chips)
Seat 8: Cyan Diogenes (9980 in chips)
ericpoker194: posts the ante 85
dimasiktuta: posts the ante 85
cpbf: posts the ante 85
D.Leonoff: posts the ante 85
boensen1982: posts the ante 85
phpro: posts the ante 85
7SkYy: posts the ante 85
Cyan Diogenes: posts the ante 85
ericpoker194: posts small blind 350
dimasiktuta: posts big blind 700
*** HOLE CARDS ***
Dealt to phpro [3c 4d]
cpbf: folds
D.Leonoff: folds
boensen1982: raises 700 to 1400
phpro: folds
7SkYy: calls 1400
Cyan Diogenes: raises 8495 to 9895 and is all-in
ericpoker194: folds
dimasiktuta: folds
boensen1982: raises 2083 to 11978 and is all-in
7SkYy: folds
Uncalled bet (2083) returned to boensen1982
*** FLOP *** [7h 6d Js]
*** TURN *** [7h 6d Js] [Jc]
*** RIVER *** [7h 6d Js Jc] [Qd]
*** SHOW DOWN ***
boensen1982: shows [Kd Kc] (two pair, Kings and Jacks)
Cyan Diogenes: shows [Ad Qs] (two pair, Queens and Jacks)
boensen1982 collected 22920 from pot
Cyan Diogenes finished the tournament in 43rd place and received $1.75.
*** SUMMARY ***
Total pot 22920 | Rake 0
Board [7h 6d Js Jc Qd]
Seat 1: ericpoker194 (small blind) folded before Flop
Seat 2: dimasiktuta (big blind) folded before Flop
Seat 3: cpbf folded before Flop (didn't bet)
Seat 4: D.Leonoff folded before Flop (didn't bet)
Seat 5: boensen1982 showed [Kd Kc] and won (22920) with two pair, Kings and Jacks
Seat 6: phpro folded before Flop (didn't bet)
Seat 7: 7SkYy folded before Flop
Seat 8: Cyan Diogenes (button) showed [Ad Qs] and lost with two pair, Queens and Jacks


*********** # 110 **************
PokerStars Hand #257046928131: Tournament #3910307458, $0.98+$0.12 USD Hold'em No Limit - Level XVI (400/800) - 2025/07/22 12:04:43 ET
Table '3910307458 12' 9-max Seat #1 is the button
Seat 1: ericpoker194 (16086 in chips)
Seat 2: dimasiktuta (67660 in chips)
Seat 3: cpbf (12037 in chips)
Seat 4: D.Leonoff (23980 in chips)
Seat 5: boensen1982 (25003 in chips)
Seat 6: phpro (16185 in chips)
Seat 7: 7SkYy (29403 in chips)
ericpoker194: posts the ante 100
dimasiktuta: posts the ante 100
cpbf: posts the ante 100
D.Leonoff: posts the ante 100
boensen1982: posts the ante 100
phpro: posts the ante 100
7SkYy: posts the ante 100
dimasiktuta: posts small blind 400
cpbf: posts big blind 800
*** HOLE CARDS ***
Dealt to phpro [6h 8c]
D.Leonoff: folds
boensen1982: raises 880 to 1680
phpro: folds
7SkYy: folds
ericpoker194: folds
dimasiktuta: calls 1280
cpbf: folds
*** FLOP *** [2s Td Jc]
dimasiktuta: checks
boensen1982: checks
*** TURN *** [2s Td Jc] [Jd]
dimasiktuta: bets 1701
boensen1982: calls 1701
*** RIVER *** [2s Td Jc Jd] [Js]
dimasiktuta: bets 4000
boensen1982: calls 4000
*** SHOW DOWN ***
dimasiktuta: shows [Ad As] (a full house, Jacks full of Aces)
boensen1982: mucks hand
dimasiktuta collected 16262 from pot
*** SUMMARY ***
Total pot 16262 | Rake 0
Board [2s Td Jc Jd Js]
Seat 1: ericpoker194 (button) folded before Flop (didn't bet)
Seat 2: dimasiktuta (small blind) showed [Ad As] and won (16262) with a full house, Jacks full of Aces
Seat 3: cpbf (big blind) folded before Flop
Seat 4: D.Leonoff folded before Flop (didn't bet)
Seat 5: boensen1982 mucked [9c 9s]
Seat 6: phpro folded before Flop (didn't bet)
Seat 7: 7SkYy folded before Flop (didn't bet)


*********** # 111 **************
PokerStars Hand #257046938881: Tournament #3910307458, $0.98+$0.12 USD Hold'em No Limit - Level XVI (400/800) - 2025/07/22 12:05:45 ET
Table '3910307458 12' 9-max Seat #2 is the button
Seat 1: ericpoker194 (15986 in chips)
Seat 2: dimasiktuta (76441 in chips)
Seat 3: cpbf (11137 in chips)
Seat 4: D.Leonoff (23880 in chips)
Seat 5: boensen1982 (17522 in chips)
Seat 6: phpro (16085 in chips)
Seat 7: 7SkYy (29303 in chips)
Seat 8: Poyosugi (21495 in chips)
ericpoker194: posts the ante 100
dimasiktuta: posts the ante 100
cpbf: posts the ante 100
D.Leonoff: posts the ante 100
boensen1982: posts the ante 100
phpro: posts the ante 100
7SkYy: posts the ante 100
Poyosugi: posts the ante 100
cpbf: posts small blind 400
D.Leonoff: posts big blind 800
*** HOLE CARDS ***
Dealt to phpro [9s Td]
boensen1982: folds
phpro: folds
7SkYy: folds
Poyosugi: calls 800
ericpoker194: folds
dimasiktuta: folds
cpbf has timed out
cpbf: folds
cpbf is sitting out
cpbf has returned
D.Leonoff: checks
*** FLOP *** [Jd 2s 2c]
D.Leonoff: checks
Poyosugi: bets 800
D.Leonoff: folds
Uncalled bet (800) returned to Poyosugi
Poyosugi collected 2800 from pot
*** SUMMARY ***
Total pot 2800 | Rake 0
Board [Jd 2s 2c]
Seat 1: ericpoker194 folded before Flop (didn't bet)
Seat 2: dimasiktuta (button) folded before Flop (didn't bet)
Seat 3: cpbf (small blind) folded before Flop
Seat 4: D.Leonoff (big blind) folded on the Flop
Seat 5: boensen1982 folded before Flop (didn't bet)
Seat 6: phpro folded before Flop (didn't bet)
Seat 7: 7SkYy folded before Flop (didn't bet)
Seat 8: Poyosugi collected (2800)


*********** # 112 **************
PokerStars Hand #257046953142: Tournament #3910307458, $0.98+$0.12 USD Hold'em No Limit - Level XVI (400/800) - 2025/07/22 12:07:08 ET
Table '3910307458 12' 9-max Seat #3 is the button
Seat 1: ericpoker194 (15886 in chips)
Seat 2: dimasiktuta (76341 in chips)
Seat 3: cpbf (10637 in chips)
Seat 4: D.Leonoff (22980 in chips)
Seat 5: boensen1982 (17422 in chips)
Seat 6: phpro (15985 in chips)
Seat 7: 7SkYy (29203 in chips)
Seat 8: Poyosugi (23395 in chips)
ericpoker194: posts the ante 100
dimasiktuta: posts the ante 100
cpbf: posts the ante 100
D.Leonoff: posts the ante 100
boensen1982: posts the ante 100
phpro: posts the ante 100
7SkYy: posts the ante 100
Poyosugi: posts the ante 100
D.Leonoff: posts small blind 400
boensen1982: posts big blind 800
*** HOLE CARDS ***
Dealt to phpro [3s Th]
phpro: folds
7SkYy: folds
Poyosugi: folds
ericpoker194: folds
dimasiktuta: raises 800 to 1600
cpbf: raises 8937 to 10537 and is all-in
D.Leonoff: folds
boensen1982: folds
dimasiktuta: calls 8937
*** FLOP *** [8c 5c 4s]
*** TURN *** [8c 5c 4s] [8d]
*** RIVER *** [8c 5c 4s 8d] [8s]
*** SHOW DOWN ***
dimasiktuta: shows [Ac 7s] (three of a kind, Eights)
cpbf: shows [3h 3c] (a full house, Eights full of Threes)
cpbf collected 23074 from pot
*** SUMMARY ***
Total pot 23074 | Rake 0
Board [8c 5c 4s 8d 8s]
Seat 1: ericpoker194 folded before Flop (didn't bet)
Seat 2: dimasiktuta showed [Ac 7s] and lost with three of a kind, Eights
Seat 3: cpbf (button) showed [3h 3c] and won (23074) with a full house, Eights full of Threes
Seat 4: D.Leonoff (small blind) folded before Flop
Seat 5: boensen1982 (big blind) folded before Flop
Seat 6: phpro folded before Flop (didn't bet)
Seat 7: 7SkYy folded before Flop (didn't bet)
Seat 8: Poyosugi folded before Flop (didn't bet)


*********** # 113 **************
PokerStars Hand #257046961526: Tournament #3910307458, $0.98+$0.12 USD Hold'em No Limit - Level XVI (400/800) - 2025/07/22 12:07:56 ET
Table '3910307458 12' 9-max Seat #4 is the button
Seat 1: ericpoker194 (15786 in chips)
Seat 2: dimasiktuta (65704 in chips)
Seat 3: cpbf (23074 in chips)
Seat 4: D.Leonoff (22480 in chips)
Seat 5: boensen1982 (16522 in chips)
Seat 6: phpro (15885 in chips)
Seat 7: 7SkYy (29103 in chips)
Seat 8: Poyosugi (23295 in chips)
ericpoker194: posts the ante 100
dimasiktuta: posts the ante 100
cpbf: posts the ante 100
D.Leonoff: posts the ante 100
boensen1982: posts the ante 100
phpro: posts the ante 100
7SkYy: posts the ante 100
Poyosugi: posts the ante 100
boensen1982: posts small blind 400
phpro: posts big blind 800
*** HOLE CARDS ***
Dealt to phpro [8h 3c]
7SkYy: raises 800 to 1600
Poyosugi: folds
ericpoker194: folds
dimasiktuta: folds
cpbf: folds
D.Leonoff: folds
boensen1982: folds
phpro: folds
Uncalled bet (800) returned to 7SkYy
7SkYy collected 2800 from pot
7SkYy: doesn't show hand
*** SUMMARY ***
Total pot 2800 | Rake 0
Seat 1: ericpoker194 folded before Flop (didn't bet)
Seat 2: dimasiktuta folded before Flop (didn't bet)
Seat 3: cpbf folded before Flop (didn't bet)
Seat 4: D.Leonoff (button) folded before Flop (didn't bet)
Seat 5: boensen1982 (small blind) folded before Flop
Seat 6: phpro (big blind) folded before Flop
Seat 7: 7SkYy collected (2800)
Seat 8: Poyosugi folded before Flop (didn't bet)


*********** # 114 **************
PokerStars Hand #257046966672: Tournament #3910307458, $0.98+$0.12 USD Hold'em No Limit - Level XVI (400/800) - 2025/07/22 12:08:27 ET
Table '3910307458 12' 9-max Seat #5 is the button
Seat 1: ericpoker194 (15686 in chips)
Seat 2: dimasiktuta (65604 in chips)
Seat 3: cpbf (22974 in chips)
Seat 4: D.Leonoff (22380 in chips)
Seat 5: boensen1982 (16022 in chips)
Seat 6: phpro (14985 in chips)
Seat 7: 7SkYy (31003 in chips)
Seat 8: Poyosugi (23195 in chips)
ericpoker194: posts the ante 100
dimasiktuta: posts the ante 100
cpbf: posts the ante 100
D.Leonoff: posts the ante 100
boensen1982: posts the ante 100
phpro: posts the ante 100
7SkYy: posts the ante 100
Poyosugi: posts the ante 100
phpro: posts small blind 400
7SkYy: posts big blind 800
*** HOLE CARDS ***
Dealt to phpro [5s Kd]
Poyosugi: calls 800
ericpoker194: folds
dimasiktuta: folds
cpbf: folds
D.Leonoff: folds
boensen1982: calls 800
phpro: folds
7SkYy: checks
*** FLOP *** [4s 7s 6h]
7SkYy: checks
Poyosugi: checks
boensen1982: bets 2000
7SkYy: calls 2000
Poyosugi: folds
*** TURN *** [4s 7s 6h] [7d]
7SkYy: bets 3800
boensen1982: calls 3800
*** RIVER *** [4s 7s 6h 7d] [4c]
7SkYy: checks
boensen1982: checks
*** SHOW DOWN ***
7SkYy: shows [Jd 8s] (two pair, Sevens and Fours)
boensen1982: shows [5c 6c] (two pair, Sevens and Sixes)
boensen1982 collected 15200 from pot
*** SUMMARY ***
Total pot 15200 | Rake 0
Board [4s 7s 6h 7d 4c]
Seat 1: ericpoker194 folded before Flop (didn't bet)
Seat 2: dimasiktuta folded before Flop (didn't bet)
Seat 3: cpbf folded before Flop (didn't bet)
Seat 4: D.Leonoff folded before Flop (didn't bet)
Seat 5: boensen1982 (button) showed [5c 6c] and won (15200) with two pair, Sevens and Sixes
Seat 6: phpro (small blind) folded before Flop
Seat 7: 7SkYy (big blind) showed [Jd 8s] and lost with two pair, Sevens and Fours
Seat 8: Poyosugi folded on the Flop


*********** # 115 **************
PokerStars Hand #257046982165: Tournament #3910307458, $0.98+$0.12 USD Hold'em No Limit - Level XVI (400/800) - 2025/07/22 12:09:57 ET
Table '3910307458 12' 9-max Seat #6 is the button
Seat 1: ericpoker194 (15586 in chips)
Seat 2: dimasiktuta (65504 in chips)
Seat 3: cpbf (22874 in chips)
Seat 4: D.Leonoff (22280 in chips)
Seat 5: boensen1982 (24522 in chips)
Seat 6: phpro (14485 in chips)
Seat 7: 7SkYy (24303 in chips)
Seat 8: Poyosugi (22295 in chips)
ericpoker194: posts the ante 100
dimasiktuta: posts the ante 100
cpbf: posts the ante 100
D.Leonoff: posts the ante 100
boensen1982: posts the ante 100
phpro: posts the ante 100
7SkYy: posts the ante 100
Poyosugi: posts the ante 100
7SkYy: posts small blind 400
Poyosugi: posts big blind 800
*** HOLE CARDS ***
Dealt to phpro [Qh 6d]
ericpoker194: folds
dimasiktuta: folds
cpbf: folds
D.Leonoff: raises 960 to 1760
boensen1982: folds
phpro: folds
7SkYy: folds
Poyosugi: folds
Uncalled bet (960) returned to D.Leonoff
D.Leonoff collected 2800 from pot
D.Leonoff: doesn't show hand
*** SUMMARY ***
Total pot 2800 | Rake 0
Seat 1: ericpoker194 folded before Flop (didn't bet)
Seat 2: dimasiktuta folded before Flop (didn't bet)
Seat 3: cpbf folded before Flop (didn't bet)
Seat 4: D.Leonoff collected (2800)
Seat 5: boensen1982 folded before Flop (didn't bet)
Seat 6: phpro (button) folded before Flop (didn't bet)
Seat 7: 7SkYy (small blind) folded before Flop
Seat 8: Poyosugi (big blind) folded before Flop


*********** # 116 **************
PokerStars Hand #257046987405: Tournament #3910307458, $0.98+$0.12 USD Hold'em No Limit - Level XVI (400/800) - 2025/07/22 12:10:28 ET
Table '3910307458 12' 9-max Seat #7 is the button
Seat 1: ericpoker194 (15486 in chips)
Seat 2: dimasiktuta (65404 in chips)
Seat 3: cpbf (22774 in chips)
Seat 4: D.Leonoff (24180 in chips)
Seat 5: boensen1982 (24422 in chips)
Seat 6: phpro (14385 in chips)
Seat 7: 7SkYy (23803 in chips)
Seat 8: Poyosugi (21395 in chips)
ericpoker194: posts the ante 100
dimasiktuta: posts the ante 100
cpbf: posts the ante 100
D.Leonoff: posts the ante 100
boensen1982: posts the ante 100
phpro: posts the ante 100
7SkYy: posts the ante 100
Poyosugi: posts the ante 100
Poyosugi: posts small blind 400
ericpoker194: posts big blind 800
*** HOLE CARDS ***
Dealt to phpro [3d Ts]
dimasiktuta: folds
cpbf: folds
D.Leonoff: folds
boensen1982: folds
phpro: folds
7SkYy: raises 800 to 1600
Poyosugi: folds
ericpoker194: folds
Uncalled bet (800) returned to 7SkYy
7SkYy collected 2800 from pot
7SkYy: doesn't show hand
*** SUMMARY ***
Total pot 2800 | Rake 0
Seat 1: ericpoker194 (big blind) folded before Flop
Seat 2: dimasiktuta folded before Flop (didn't bet)
Seat 3: cpbf folded before Flop (didn't bet)
Seat 4: D.Leonoff folded before Flop (didn't bet)
Seat 5: boensen1982 folded before Flop (didn't bet)
Seat 6: phpro folded before Flop (didn't bet)
Seat 7: 7SkYy (button) collected (2800)
Seat 8: Poyosugi (small blind) folded before Flop


*********** # 117 **************
PokerStars Hand #257046993478: Tournament #3910307458, $0.98+$0.12 USD Hold'em No Limit - Level XVI (400/800) - 2025/07/22 12:11:02 ET
Table '3910307458 12' 9-max Seat #8 is the button
Seat 1: ericpoker194 (14586 in chips)
Seat 2: dimasiktuta (65304 in chips)
Seat 3: cpbf (22674 in chips)
Seat 4: D.Leonoff (24080 in chips)
Seat 5: boensen1982 (24322 in chips)
Seat 6: phpro (14285 in chips)
Seat 7: 7SkYy (25703 in chips)
Seat 8: Poyosugi (20895 in chips)
ericpoker194: posts the ante 100
dimasiktuta: posts the ante 100
cpbf: posts the ante 100
D.Leonoff: posts the ante 100
boensen1982: posts the ante 100
phpro: posts the ante 100
7SkYy: posts the ante 100
Poyosugi: posts the ante 100
ericpoker194: posts small blind 400
dimasiktuta: posts big blind 800
*** HOLE CARDS ***
Dealt to phpro [2h As]
cpbf has timed out
cpbf: folds
cpbf is sitting out
D.Leonoff: folds
boensen1982: folds
cpbf has returned
phpro: folds
7SkYy: folds
Poyosugi: folds
ericpoker194: calls 400
dimasiktuta: raises 64404 to 65204 and is all-in
ericpoker194: calls 13686 and is all-in
Uncalled bet (50718) returned to dimasiktuta
*** FLOP *** [9s 5d 7s]
*** TURN *** [9s 5d 7s] [7d]
*** RIVER *** [9s 5d 7s 7d] [3h]
*** SHOW DOWN ***
ericpoker194: shows [Kc 9h] (two pair, Nines and Sevens)
dimasiktuta: shows [Kh Ac] (a pair of Sevens)
ericpoker194 collected 29772 from pot
*** SUMMARY ***
Total pot 29772 | Rake 0
Board [9s 5d 7s 7d 3h]
Seat 1: ericpoker194 (small blind) showed [Kc 9h] and won (29772) with two pair, Nines and Sevens
Seat 2: dimasiktuta (big blind) showed [Kh Ac] and lost with a pair of Sevens
Seat 3: cpbf folded before Flop (didn't bet)
Seat 4: D.Leonoff folded before Flop (didn't bet)
Seat 5: boensen1982 folded before Flop (didn't bet)
Seat 6: phpro folded before Flop (didn't bet)
Seat 7: 7SkYy folded before Flop (didn't bet)
Seat 8: Poyosugi (button) folded before Flop (didn't bet)


*********** # 118 **************
PokerStars Hand #257047001452: Tournament #3910307458, $0.98+$0.12 USD Hold'em No Limit - Level XVI (400/800) - 2025/07/22 12:11:48 ET
Table '3910307458 12' 9-max Seat #1 is the button
Seat 1: ericpoker194 (29772 in chips)
Seat 2: dimasiktuta (50718 in chips)
Seat 3: cpbf (22574 in chips)
Seat 4: D.Leonoff (23980 in chips)
Seat 5: boensen1982 (24222 in chips)
Seat 6: phpro (14185 in chips)
Seat 7: 7SkYy (25603 in chips)
Seat 8: Poyosugi (20795 in chips)
ericpoker194: posts the ante 100
dimasiktuta: posts the ante 100
cpbf: posts the ante 100
D.Leonoff: posts the ante 100
boensen1982: posts the ante 100
phpro: posts the ante 100
7SkYy: posts the ante 100
Poyosugi: posts the ante 100
dimasiktuta: posts small blind 400
cpbf: posts big blind 800
*** HOLE CARDS ***
Dealt to phpro [5h 5c]
D.Leonoff: folds
boensen1982: raises 880 to 1680
phpro: folds
7SkYy: folds
Poyosugi: folds
ericpoker194: folds
dimasiktuta: folds
cpbf: folds
Uncalled bet (880) returned to boensen1982
boensen1982 collected 2800 from pot
boensen1982: doesn't show hand
*** SUMMARY ***
Total pot 2800 | Rake 0
Seat 1: ericpoker194 (button) folded before Flop (didn't bet)
Seat 2: dimasiktuta (small blind) folded before Flop
Seat 3: cpbf (big blind) folded before Flop
Seat 4: D.Leonoff folded before Flop (didn't bet)
Seat 5: boensen1982 collected (2800)
Seat 6: phpro folded before Flop (didn't bet)
Seat 7: 7SkYy folded before Flop (didn't bet)
Seat 8: Poyosugi folded before Flop (didn't bet)


*********** # 119 **************
PokerStars Hand #257047008947: Tournament #3910307458, $0.98+$0.12 USD Hold'em No Limit - Level XVI (400/800) - 2025/07/22 12:12:31 ET
Table '3910307458 12' 9-max Seat #2 is the button
Seat 1: ericpoker194 (29672 in chips)
Seat 2: dimasiktuta (50218 in chips)
Seat 3: cpbf (21674 in chips)
Seat 4: D.Leonoff (23880 in chips)
Seat 5: boensen1982 (26122 in chips)
Seat 6: phpro (14085 in chips)
Seat 7: 7SkYy (25503 in chips)
Seat 8: Poyosugi (20695 in chips)
ericpoker194: posts the ante 100
dimasiktuta: posts the ante 100
cpbf: posts the ante 100
D.Leonoff: posts the ante 100
boensen1982: posts the ante 100
phpro: posts the ante 100
7SkYy: posts the ante 100
Poyosugi: posts the ante 100
cpbf: posts small blind 400
D.Leonoff: posts big blind 800
*** HOLE CARDS ***
Dealt to phpro [5h Qs]
boensen1982: folds
phpro: folds
7SkYy: folds
Poyosugi: folds
ericpoker194: raises 800 to 1600
dimasiktuta: folds
cpbf: folds
D.Leonoff: calls 800
*** FLOP *** [9h 9d Ah]
D.Leonoff: checks
ericpoker194: bets 1600
D.Leonoff: folds
Uncalled bet (1600) returned to ericpoker194
ericpoker194 collected 4400 from pot
ericpoker194: doesn't show hand
*** SUMMARY ***
Total pot 4400 | Rake 0
Board [9h 9d Ah]
Seat 1: ericpoker194 collected (4400)
Seat 2: dimasiktuta (button) folded before Flop (didn't bet)
Seat 3: cpbf (small blind) folded before Flop
Seat 4: D.Leonoff (big blind) folded on the Flop
Seat 5: boensen1982 folded before Flop (didn't bet)
Seat 6: phpro folded before Flop (didn't bet)
Seat 7: 7SkYy folded before Flop (didn't bet)
Seat 8: Poyosugi folded before Flop (didn't bet)


*********** # 120 **************
PokerStars Hand #257047016378: Tournament #3910307458, $0.98+$0.12 USD Hold'em No Limit - Level XVI (400/800) - 2025/07/22 12:13:13 ET
Table '3910307458 12' 9-max Seat #3 is the button
Seat 1: ericpoker194 (32372 in chips)
Seat 2: dimasiktuta (50118 in chips)
Seat 3: cpbf (21174 in chips)
Seat 4: D.Leonoff (22180 in chips)
Seat 5: boensen1982 (26022 in chips)
Seat 6: phpro (13985 in chips)
Seat 7: 7SkYy (25403 in chips)
Seat 8: Poyosugi (20595 in chips)
ericpoker194: posts the ante 100
dimasiktuta: posts the ante 100
cpbf: posts the ante 100
D.Leonoff: posts the ante 100
boensen1982: posts the ante 100
phpro: posts the ante 100
7SkYy: posts the ante 100
Poyosugi: posts the ante 100
D.Leonoff: posts small blind 400
boensen1982: posts big blind 800
*** HOLE CARDS ***
Dealt to phpro [Th Jc]
phpro: folds
7SkYy: raises 800 to 1600
Poyosugi: folds
ericpoker194: folds
dimasiktuta: folds
cpbf: folds
D.Leonoff: folds
boensen1982: calls 800
*** FLOP *** [4h 2s 6d]
boensen1982: checks
7SkYy: checks
*** TURN *** [4h 2s 6d] [5c]
boensen1982: bets 2400
7SkYy: folds
Uncalled bet (2400) returned to boensen1982
boensen1982 collected 4400 from pot
boensen1982: doesn't show hand
*** SUMMARY ***
Total pot 4400 | Rake 0
Board [4h 2s 6d 5c]
Seat 1: ericpoker194 folded before Flop (didn't bet)
Seat 2: dimasiktuta folded before Flop (didn't bet)
Seat 3: cpbf (button) folded before Flop (didn't bet)
Seat 4: D.Leonoff (small blind) folded before Flop
Seat 5: boensen1982 (big blind) collected (4400)
Seat 6: phpro folded before Flop (didn't bet)
Seat 7: 7SkYy folded on the Turn
Seat 8: Poyosugi folded before Flop (didn't bet)


*********** # 121 **************
PokerStars Hand #257047026165: Tournament #3910307458, $0.98+$0.12 USD Hold'em No Limit - Level XVI (400/800) - 2025/07/22 12:14:08 ET
Table '3910307458 12' 9-max Seat #4 is the button
Seat 1: ericpoker194 (32272 in chips)
Seat 2: dimasiktuta (50018 in chips)
Seat 3: cpbf (21074 in chips)
Seat 4: D.Leonoff (21680 in chips)
Seat 5: boensen1982 (28722 in chips)
Seat 6: phpro (13885 in chips)
Seat 7: 7SkYy (23703 in chips)
Seat 8: Poyosugi (20495 in chips)
ericpoker194: posts the ante 100
dimasiktuta: posts the ante 100
cpbf: posts the ante 100
D.Leonoff: posts the ante 100
boensen1982: posts the ante 100
phpro: posts the ante 100
7SkYy: posts the ante 100
Poyosugi: posts the ante 100
boensen1982: posts small blind 400
phpro: posts big blind 800
*** HOLE CARDS ***
Dealt to phpro [7c 2d]
7SkYy: folds
Poyosugi: folds
ericpoker194: folds
dimasiktuta: folds
cpbf: raises 800 to 1600
D.Leonoff: folds
boensen1982: folds
phpro: folds
Uncalled bet (800) returned to cpbf
cpbf collected 2800 from pot
cpbf: doesn't show hand
*** SUMMARY ***
Total pot 2800 | Rake 0
Seat 1: ericpoker194 folded before Flop (didn't bet)
Seat 2: dimasiktuta folded before Flop (didn't bet)
Seat 3: cpbf collected (2800)
Seat 4: D.Leonoff (button) folded before Flop (didn't bet)
Seat 5: boensen1982 (small blind) folded before Flop
Seat 6: phpro (big blind) folded before Flop
Seat 7: 7SkYy folded before Flop (didn't bet)
Seat 8: Poyosugi folded before Flop (didn't bet)


*********** # 122 **************
PokerStars Hand #257047032228: Tournament #3910307458, $0.98+$0.12 USD Hold'em No Limit - Level XVII (500/1000) - 2025/07/22 12:14:43 ET
Table '3910307458 12' 9-max Seat #5 is the button
Seat 1: ericpoker194 (32172 in chips)
Seat 2: dimasiktuta (49918 in chips)
Seat 3: cpbf (22974 in chips)
Seat 4: D.Leonoff (21580 in chips)
Seat 5: boensen1982 (28222 in chips)
Seat 6: phpro (12985 in chips)
Seat 7: 7SkYy (23603 in chips)
Seat 8: Poyosugi (20395 in chips)
ericpoker194: posts the ante 125
dimasiktuta: posts the ante 125
cpbf: posts the ante 125
D.Leonoff: posts the ante 125
boensen1982: posts the ante 125
phpro: posts the ante 125
7SkYy: posts the ante 125
Poyosugi: posts the ante 125
phpro: posts small blind 500
7SkYy: posts big blind 1000
*** HOLE CARDS ***
Dealt to phpro [Tc Ah]
Poyosugi: folds
ericpoker194: folds
dimasiktuta: folds
cpbf: raises 1000 to 2000
D.Leonoff: calls 2000
boensen1982: folds
phpro: folds
7SkYy: calls 1000
*** FLOP *** [8c Jd 7h]
7SkYy: checks
cpbf: checks
D.Leonoff: bets 1500
7SkYy: folds
cpbf: raises 3400 to 4900
D.Leonoff: calls 3400
*** TURN *** [8c Jd 7h] [Jc]
cpbf: checks
D.Leonoff: bets 5709
cpbf: folds
Uncalled bet (5709) returned to D.Leonoff
D.Leonoff collected 17300 from pot
D.Leonoff: doesn't show hand
*** SUMMARY ***
Total pot 17300 | Rake 0
Board [8c Jd 7h Jc]
Seat 1: ericpoker194 folded before Flop (didn't bet)
Seat 2: dimasiktuta folded before Flop (didn't bet)
Seat 3: cpbf folded on the Turn
Seat 4: D.Leonoff collected (17300)
Seat 5: boensen1982 (button) folded before Flop (didn't bet)
Seat 6: phpro (small blind) folded before Flop
Seat 7: 7SkYy (big blind) folded on the Flop
Seat 8: Poyosugi folded before Flop (didn't bet)


*********** # 123 **************
PokerStars Hand #257047052149: Tournament #3910307458, $0.98+$0.12 USD Hold'em No Limit - Level XVII (500/1000) - 2025/07/22 12:16:34 ET
Table '3910307458 12' 9-max Seat #6 is the button
Seat 1: ericpoker194 (32047 in chips)
Seat 2: dimasiktuta (49793 in chips)
Seat 3: cpbf (15949 in chips)
Seat 4: D.Leonoff (31855 in chips)
Seat 5: boensen1982 (28097 in chips)
Seat 6: phpro (12360 in chips)
Seat 7: 7SkYy (21478 in chips)
Seat 8: Poyosugi (20270 in chips)
ericpoker194: posts the ante 125
dimasiktuta: posts the ante 125
cpbf: posts the ante 125
D.Leonoff: posts the ante 125
boensen1982: posts the ante 125
phpro: posts the ante 125
7SkYy: posts the ante 125
Poyosugi: posts the ante 125
7SkYy: posts small blind 500
Poyosugi: posts big blind 1000
*** HOLE CARDS ***
Dealt to phpro [4h 5d]
ericpoker194: folds
dimasiktuta: folds
xxAlHixx is disconnected
cpbf has timed out
cpbf: folds
cpbf is sitting out
D.Leonoff: folds
boensen1982: raises 1000 to 2000
phpro: folds
7SkYy: folds
Poyosugi: calls 1000
*** FLOP *** [3c 8h 6d]
cpbf has returned
Poyosugi: checks
boensen1982: checks
*** TURN *** [3c 8h 6d] [5c]
Poyosugi: checks
boensen1982: checks
*** RIVER *** [3c 8h 6d 5c] [3h]
Poyosugi: checks
boensen1982: checks
*** SHOW DOWN ***
Poyosugi: shows [2s Kc] (a pair of Threes)
boensen1982: shows [Ac Ts] (a pair of Threes - Ace kicker)
boensen1982 collected 5500 from pot
*** SUMMARY ***
Total pot 5500 | Rake 0
Board [3c 8h 6d 5c 3h]
Seat 1: ericpoker194 folded before Flop (didn't bet)
Seat 2: dimasiktuta folded before Flop (didn't bet)
Seat 3: cpbf folded before Flop (didn't bet)
Seat 4: D.Leonoff folded before Flop (didn't bet)
Seat 5: boensen1982 showed [Ac Ts] and won (5500) with a pair of Threes
Seat 6: phpro (button) folded before Flop (didn't bet)
Seat 7: 7SkYy (small blind) folded before Flop
Seat 8: Poyosugi (big blind) showed [2s Kc] and lost with a pair of Threes


*********** # 124 **************
PokerStars Hand #257047062183: Tournament #3910307458, $0.98+$0.12 USD Hold'em No Limit - Level XVII (500/1000) - 2025/07/22 12:17:31 ET
Table '3910307458 12' 9-max Seat #7 is the button
Seat 1: ericpoker194 (31922 in chips)
Seat 2: dimasiktuta (49668 in chips)
Seat 3: cpbf (15824 in chips)
Seat 4: D.Leonoff (31730 in chips)
Seat 5: boensen1982 (31472 in chips)
Seat 6: phpro (12235 in chips)
Seat 7: 7SkYy (20853 in chips)
Seat 8: Poyosugi (18145 in chips)
Seat 9: xxAlHixx (13255 in chips)
ericpoker194: posts the ante 125
dimasiktuta: posts the ante 125
cpbf: posts the ante 125
D.Leonoff: posts the ante 125
boensen1982: posts the ante 125
phpro: posts the ante 125
7SkYy: posts the ante 125
Poyosugi: posts the ante 125
xxAlHixx: posts the ante 125
Poyosugi: posts small blind 500
xxAlHixx: posts big blind 1000
*** HOLE CARDS ***
Dealt to phpro [3d 7d]
ericpoker194: folds
dimasiktuta: folds
cpbf: folds
D.Leonoff: folds
boensen1982: folds
phpro: folds
7SkYy: folds
Poyosugi: calls 500
xxAlHixx: checks
*** FLOP *** [As 6h Ks]
Poyosugi: checks
xxAlHixx: checks
*** TURN *** [As 6h Ks] [Kd]
Poyosugi: bets 1000
xxAlHixx: folds
Uncalled bet (1000) returned to Poyosugi
Poyosugi collected 3125 from pot
*** SUMMARY ***
Total pot 3125 | Rake 0
Board [As 6h Ks Kd]
Seat 1: ericpoker194 folded before Flop (didn't bet)
Seat 2: dimasiktuta folded before Flop (didn't bet)
Seat 3: cpbf folded before Flop (didn't bet)
Seat 4: D.Leonoff folded before Flop (didn't bet)
Seat 5: boensen1982 folded before Flop (didn't bet)
Seat 6: phpro folded before Flop (didn't bet)
Seat 7: 7SkYy (button) folded before Flop (didn't bet)
Seat 8: Poyosugi (small blind) collected (3125)
Seat 9: xxAlHixx (big blind) folded on the Turn


*********** # 125 **************
PokerStars Hand #257047071072: Tournament #3910307458, $0.98+$0.12 USD Hold'em No Limit - Level XVII (500/1000) - 2025/07/22 12:18:21 ET
Table '3910307458 12' 9-max Seat #8 is the button
Seat 1: ericpoker194 (31797 in chips)
Seat 2: dimasiktuta (49543 in chips)
Seat 3: cpbf (15699 in chips)
Seat 4: D.Leonoff (31605 in chips)
Seat 5: boensen1982 (31347 in chips)
Seat 6: phpro (12110 in chips)
Seat 7: 7SkYy (20728 in chips)
Seat 8: Poyosugi (20145 in chips)
Seat 9: xxAlHixx (12130 in chips)
ericpoker194: posts the ante 125
dimasiktuta: posts the ante 125
cpbf: posts the ante 125
D.Leonoff: posts the ante 125
boensen1982: posts the ante 125
phpro: posts the ante 125
7SkYy: posts the ante 125
Poyosugi: posts the ante 125
xxAlHixx: posts the ante 125
xxAlHixx: posts small blind 500
ericpoker194: posts big blind 1000
*** HOLE CARDS ***
Dealt to phpro [3s Ah]
dimasiktuta: folds
cpbf: folds
D.Leonoff: folds
boensen1982: folds
phpro: folds
7SkYy: folds
Poyosugi: folds
xxAlHixx: calls 500
ericpoker194: raises 2000 to 3000
xxAlHixx: folds
Uncalled bet (2000) returned to ericpoker194
ericpoker194 collected 3125 from pot
ericpoker194: doesn't show hand
*** SUMMARY ***
Total pot 3125 | Rake 0
Seat 1: ericpoker194 (big blind) collected (3125)
Seat 2: dimasiktuta folded before Flop (didn't bet)
Seat 3: cpbf folded before Flop (didn't bet)
Seat 4: D.Leonoff folded before Flop (didn't bet)
Seat 5: boensen1982 folded before Flop (didn't bet)
Seat 6: phpro folded before Flop (didn't bet)
Seat 7: 7SkYy folded before Flop (didn't bet)
Seat 8: Poyosugi (button) folded before Flop (didn't bet)
Seat 9: xxAlHixx (small blind) folded before Flop


*********** # 126 **************
PokerStars Hand #257047076545: Tournament #3910307458, $0.98+$0.12 USD Hold'em No Limit - Level XVII (500/1000) - 2025/07/22 12:18:51 ET
Table '3910307458 12' 9-max Seat #9 is the button
Seat 1: ericpoker194 (33797 in chips)
Seat 2: dimasiktuta (49418 in chips)
Seat 3: cpbf (15574 in chips)
Seat 4: D.Leonoff (31480 in chips)
Seat 5: boensen1982 (31222 in chips)
Seat 6: phpro (11985 in chips)
Seat 7: 7SkYy (20603 in chips)
Seat 8: Poyosugi (20020 in chips)
Seat 9: xxAlHixx (11005 in chips)
ericpoker194: posts the ante 125
dimasiktuta: posts the ante 125
cpbf: posts the ante 125
D.Leonoff: posts the ante 125
boensen1982: posts the ante 125
phpro: posts the ante 125
7SkYy: posts the ante 125
Poyosugi: posts the ante 125
xxAlHixx: posts the ante 125
ericpoker194: posts small blind 500
dimasiktuta: posts big blind 1000
*** HOLE CARDS ***
Dealt to phpro [7c 9c]
cpbf: folds
D.Leonoff: folds
boensen1982: folds
phpro: folds
7SkYy has timed out
7SkYy: folds
7SkYy is sitting out
Poyosugi: folds
xxAlHixx: folds
7SkYy has returned
ericpoker194: calls 500
dimasiktuta: raises 2000 to 3000
ericpoker194: folds
Uncalled bet (2000) returned to dimasiktuta
dimasiktuta collected 3125 from pot
dimasiktuta: doesn't show hand
*** SUMMARY ***
Total pot 3125 | Rake 0
Seat 1: ericpoker194 (small blind) folded before Flop
Seat 2: dimasiktuta (big blind) collected (3125)
Seat 3: cpbf folded before Flop (didn't bet)
Seat 4: D.Leonoff folded before Flop (didn't bet)
Seat 5: boensen1982 folded before Flop (didn't bet)
Seat 6: phpro folded before Flop (didn't bet)
Seat 7: 7SkYy folded before Flop (didn't bet)
Seat 8: Poyosugi folded before Flop (didn't bet)
Seat 9: xxAlHixx (button) folded before Flop (didn't bet)


*********** # 127 **************
PokerStars Hand #257047084079: Tournament #3910307458, $0.98+$0.12 USD Hold'em No Limit - Level XVII (500/1000) - 2025/07/22 12:19:33 ET
Table '3910307458 12' 9-max Seat #1 is the button
Seat 1: ericpoker194 (32672 in chips)
Seat 2: dimasiktuta (51418 in chips)
Seat 3: cpbf (15449 in chips)
Seat 4: D.Leonoff (31355 in chips)
Seat 5: boensen1982 (31097 in chips)
Seat 6: phpro (11860 in chips)
Seat 7: 7SkYy (20478 in chips)
Seat 8: Poyosugi (19895 in chips)
Seat 9: xxAlHixx (10880 in chips)
ericpoker194: posts the ante 125
dimasiktuta: posts the ante 125
cpbf: posts the ante 125
D.Leonoff: posts the ante 125
boensen1982: posts the ante 125
phpro: posts the ante 125
7SkYy: posts the ante 125
Poyosugi: posts the ante 125
xxAlHixx: posts the ante 125
dimasiktuta: posts small blind 500
cpbf: posts big blind 1000
*** HOLE CARDS ***
Dealt to phpro [2s Qc]
D.Leonoff: folds
boensen1982: raises 1100 to 2100
phpro: folds
7SkYy: folds
Poyosugi: folds
xxAlHixx: folds
ericpoker194: folds
dimasiktuta: folds
cpbf: calls 1100
*** FLOP *** [6s Qd 8s]
cpbf: checks
boensen1982: bets 3845
cpbf: folds
Uncalled bet (3845) returned to boensen1982
boensen1982 collected 5825 from pot
boensen1982: doesn't show hand
*** SUMMARY ***
Total pot 5825 | Rake 0
Board [6s Qd 8s]
Seat 1: ericpoker194 (button) folded before Flop (didn't bet)
Seat 2: dimasiktuta (small blind) folded before Flop
Seat 3: cpbf (big blind) folded on the Flop
Seat 4: D.Leonoff folded before Flop (didn't bet)
Seat 5: boensen1982 collected (5825)
Seat 6: phpro folded before Flop (didn't bet)
Seat 7: 7SkYy folded before Flop (didn't bet)
Seat 8: Poyosugi folded before Flop (didn't bet)
Seat 9: xxAlHixx folded before Flop (didn't bet)


*********** # 128 **************
PokerStars Hand #257047094147: Tournament #3910307458, $0.98+$0.12 USD Hold'em No Limit - Level XVII (500/1000) - 2025/07/22 12:20:30 ET
Table '3910307458 12' 9-max Seat #2 is the button
Seat 1: ericpoker194 (32547 in chips)
Seat 2: dimasiktuta (50793 in chips)
Seat 3: cpbf (13224 in chips)
Seat 4: D.Leonoff (31230 in chips)
Seat 5: boensen1982 (34697 in chips)
Seat 6: phpro (11735 in chips)
Seat 7: 7SkYy (20353 in chips)
Seat 8: Poyosugi (19770 in chips)
Seat 9: xxAlHixx (10755 in chips)
ericpoker194: posts the ante 125
dimasiktuta: posts the ante 125
cpbf: posts the ante 125
D.Leonoff: posts the ante 125
boensen1982: posts the ante 125
phpro: posts the ante 125
7SkYy: posts the ante 125
Poyosugi: posts the ante 125
xxAlHixx: posts the ante 125
cpbf: posts small blind 500
D.Leonoff: posts big blind 1000
*** HOLE CARDS ***
Dealt to phpro [9c Th]
boensen1982: folds
phpro: folds
7SkYy: folds
Poyosugi: folds
xxAlHixx: folds
ericpoker194: raises 1000 to 2000
dimasiktuta: folds
cpbf: raises 11099 to 13099 and is all-in
D.Leonoff: folds
ericpoker194: folds
Uncalled bet (11099) returned to cpbf
cpbf collected 6125 from pot
cpbf: doesn't show hand
*** SUMMARY ***
Total pot 6125 | Rake 0
Seat 1: ericpoker194 folded before Flop
Seat 2: dimasiktuta (button) folded before Flop (didn't bet)
Seat 3: cpbf (small blind) collected (6125)
Seat 4: D.Leonoff (big blind) folded before Flop
Seat 5: boensen1982 folded before Flop (didn't bet)
Seat 6: phpro folded before Flop (didn't bet)
Seat 7: 7SkYy folded before Flop (didn't bet)
Seat 8: Poyosugi folded before Flop (didn't bet)
Seat 9: xxAlHixx folded before Flop (didn't bet)


*********** # 129 **************
PokerStars Hand #257047102709: Tournament #3910307458, $0.98+$0.12 USD Hold'em No Limit - Level XVII (500/1000) - 2025/07/22 12:21:17 ET
Table '3910307458 12' 9-max Seat #3 is the button
Seat 1: ericpoker194 (30422 in chips)
Seat 2: dimasiktuta (50668 in chips)
Seat 3: cpbf (17224 in chips)
Seat 4: D.Leonoff (30105 in chips)
Seat 5: boensen1982 (34572 in chips)
Seat 6: phpro (11610 in chips)
Seat 7: 7SkYy (20228 in chips)
Seat 8: Poyosugi (19645 in chips)
Seat 9: xxAlHixx (10630 in chips)
ericpoker194: posts the ante 125
dimasiktuta: posts the ante 125
cpbf: posts the ante 125
D.Leonoff: posts the ante 125
boensen1982: posts the ante 125
phpro: posts the ante 125
7SkYy: posts the ante 125
Poyosugi: posts the ante 125
xxAlHixx: posts the ante 125
D.Leonoff: posts small blind 500
boensen1982: posts big blind 1000
*** HOLE CARDS ***
Dealt to phpro [Tc 9d]
phpro: folds
7SkYy: folds
Poyosugi: folds
xxAlHixx: folds
ericpoker194: raises 1000 to 2000
dimasiktuta: calls 2000
cpbf: folds
D.Leonoff: folds
boensen1982: folds
*** FLOP *** [8h Ks 7h]
ericpoker194: checks
dimasiktuta: bets 1590
ericpoker194: folds
Uncalled bet (1590) returned to dimasiktuta
dimasiktuta collected 6625 from pot
dimasiktuta: doesn't show hand
*** SUMMARY ***
Total pot 6625 | Rake 0
Board [8h Ks 7h]
Seat 1: ericpoker194 folded on the Flop
Seat 2: dimasiktuta collected (6625)
Seat 3: cpbf (button) folded before Flop (didn't bet)
Seat 4: D.Leonoff (small blind) folded before Flop
Seat 5: boensen1982 (big blind) folded before Flop
Seat 6: phpro folded before Flop (didn't bet)
Seat 7: 7SkYy folded before Flop (didn't bet)
Seat 8: Poyosugi folded before Flop (didn't bet)
Seat 9: xxAlHixx folded before Flop (didn't bet)


*********** # 130 **************
PokerStars Hand #257047110085: Tournament #3910307458, $0.98+$0.12 USD Hold'em No Limit - Level XVII (500/1000) - 2025/07/22 12:21:58 ET
Table '3910307458 12' 9-max Seat #4 is the button
Seat 1: ericpoker194 (28297 in chips)
Seat 2: dimasiktuta (55168 in chips)
Seat 3: cpbf (17099 in chips)
Seat 4: D.Leonoff (29480 in chips)
Seat 5: boensen1982 (33447 in chips)
Seat 6: phpro (11485 in chips)
Seat 7: 7SkYy (20103 in chips)
Seat 8: Poyosugi (19520 in chips)
Seat 9: xxAlHixx (10505 in chips)
ericpoker194: posts the ante 125
dimasiktuta: posts the ante 125
cpbf: posts the ante 125
D.Leonoff: posts the ante 125
boensen1982: posts the ante 125
phpro: posts the ante 125
7SkYy: posts the ante 125
Poyosugi: posts the ante 125
xxAlHixx: posts the ante 125
boensen1982: posts small blind 500
phpro: posts big blind 1000
*** HOLE CARDS ***
Dealt to phpro [4h 9h]
7SkYy: folds
Poyosugi: calls 1000
xxAlHixx: folds
ericpoker194: folds
dimasiktuta: folds
cpbf: folds
D.Leonoff: folds
boensen1982: folds
phpro: checks
*** FLOP *** [2c Qh Js]
phpro: checks
Poyosugi: checks
*** TURN *** [2c Qh Js] [Ad]
phpro: checks
Poyosugi: bets 2000
phpro: folds
Uncalled bet (2000) returned to Poyosugi
Poyosugi collected 3625 from pot
*** SUMMARY ***
Total pot 3625 | Rake 0
Board [2c Qh Js Ad]
Seat 1: ericpoker194 folded before Flop (didn't bet)
Seat 2: dimasiktuta folded before Flop (didn't bet)
Seat 3: cpbf folded before Flop (didn't bet)
Seat 4: D.Leonoff (button) folded before Flop (didn't bet)
Seat 5: boensen1982 (small blind) folded before Flop
Seat 6: phpro (big blind) folded on the Turn
Seat 7: 7SkYy folded before Flop (didn't bet)
Seat 8: Poyosugi collected (3625)
Seat 9: xxAlHixx folded before Flop (didn't bet)


*********** # 131 **************
PokerStars Hand #257047117239: Tournament #3910307458, $0.98+$0.12 USD Hold'em No Limit - Level XVII (500/1000) - 2025/07/22 12:22:37 ET
Table '3910307458 12' 9-max Seat #5 is the button
Seat 1: ericpoker194 (28172 in chips)
Seat 2: dimasiktuta (55043 in chips)
Seat 4: D.Leonoff (29355 in chips)
Seat 5: boensen1982 (32822 in chips)
Seat 6: phpro (10360 in chips)
Seat 7: 7SkYy (19978 in chips)
Seat 8: Poyosugi (22020 in chips)
Seat 9: xxAlHixx (10380 in chips)
ericpoker194: posts the ante 125
dimasiktuta: posts the ante 125
D.Leonoff: posts the ante 125
boensen1982: posts the ante 125
phpro: posts the ante 125
7SkYy: posts the ante 125
Poyosugi: posts the ante 125
xxAlHixx: posts the ante 125
phpro: posts small blind 500
7SkYy: posts big blind 1000
*** HOLE CARDS ***
Dealt to phpro [Ks As]
Poyosugi: folds
xxAlHixx: folds
ericpoker194: folds
dimasiktuta: folds
D.Leonoff: folds
boensen1982: folds
phpro: raises 9235 to 10235 and is all-in
7SkYy: calls 9235
*** FLOP *** [Ad 6h Qd]
*** TURN *** [Ad 6h Qd] [5s]
*** RIVER *** [Ad 6h Qd 5s] [Jc]
*** SHOW DOWN ***
phpro: shows [Ks As] (a pair of Aces)
7SkYy: shows [2d 2h] (a pair of Deuces)
phpro collected 21470 from pot
*** SUMMARY ***
Total pot 21470 | Rake 0
Board [Ad 6h Qd 5s Jc]
Seat 1: ericpoker194 folded before Flop (didn't bet)
Seat 2: dimasiktuta folded before Flop (didn't bet)
Seat 4: D.Leonoff folded before Flop (didn't bet)
Seat 5: boensen1982 (button) folded before Flop (didn't bet)
Seat 6: phpro (small blind) showed [Ks As] and won (21470) with a pair of Aces
Seat 7: 7SkYy (big blind) showed [2d 2h] and lost with a pair of Deuces
Seat 8: Poyosugi folded before Flop (didn't bet)
Seat 9: xxAlHixx folded before Flop (didn't bet)


*********** # 132 **************
PokerStars Hand #257047124215: Tournament #3910307458, $0.98+$0.12 USD Hold'em No Limit - Level XVII (500/1000) - 2025/07/22 12:23:16 ET
Table '3910307458 12' 9-max Seat #6 is the button
Seat 1: ericpoker194 (28047 in chips)
Seat 2: dimasiktuta (54918 in chips)
Seat 4: D.Leonoff (29230 in chips)
Seat 5: boensen1982 (32697 in chips)
Seat 6: phpro (21470 in chips)
Seat 7: 7SkYy (9618 in chips)
Seat 8: Poyosugi (21895 in chips)
Seat 9: xxAlHixx (10255 in chips)
ericpoker194: posts the ante 125
dimasiktuta: posts the ante 125
D.Leonoff: posts the ante 125
boensen1982: posts the ante 125
phpro: posts the ante 125
7SkYy: posts the ante 125
Poyosugi: posts the ante 125
xxAlHixx: posts the ante 125
7SkYy: posts small blind 500
Poyosugi: posts big blind 1000
*** HOLE CARDS ***
Dealt to phpro [Tc 3c]
xxAlHixx: folds
ericpoker194: folds
dimasiktuta: folds
D.Leonoff: raises 1200 to 2200
boensen1982: folds
phpro: folds
7SkYy: folds
Poyosugi: folds
Uncalled bet (1200) returned to D.Leonoff
D.Leonoff collected 3500 from pot
D.Leonoff: doesn't show hand
*** SUMMARY ***
Total pot 3500 | Rake 0
Seat 1: ericpoker194 folded before Flop (didn't bet)
Seat 2: dimasiktuta folded before Flop (didn't bet)
Seat 4: D.Leonoff collected (3500)
Seat 5: boensen1982 folded before Flop (didn't bet)
Seat 6: phpro (button) folded before Flop (didn't bet)
Seat 7: 7SkYy (small blind) folded before Flop
Seat 8: Poyosugi (big blind) folded before Flop
Seat 9: xxAlHixx folded before Flop (didn't bet)


*********** # 133 **************
PokerStars Hand #257047129148: Tournament #3910307458, $0.98+$0.12 USD Hold'em No Limit - Level XVII (500/1000) - 2025/07/22 12:23:43 ET
Table '3910307458 12' 9-max Seat #7 is the button
Seat 1: ericpoker194 (27922 in chips)
Seat 2: dimasiktuta (54793 in chips)
Seat 4: D.Leonoff (31605 in chips)
Seat 5: boensen1982 (32572 in chips)
Seat 6: phpro (21345 in chips)
Seat 7: 7SkYy (8993 in chips)
Seat 8: Poyosugi (20770 in chips)
Seat 9: xxAlHixx (10130 in chips)
ericpoker194: posts the ante 125
dimasiktuta: posts the ante 125
D.Leonoff: posts the ante 125
boensen1982: posts the ante 125
phpro: posts the ante 125
7SkYy: posts the ante 125
Poyosugi: posts the ante 125
xxAlHixx: posts the ante 125
Poyosugi: posts small blind 500
xxAlHixx: posts big blind 1000
*** HOLE CARDS ***
Dealt to phpro [2h Ts]
ericpoker194: folds
dimasiktuta: folds
D.Leonoff: folds
boensen1982: folds
phpro: folds
7SkYy: raises 7868 to 8868 and is all-in
Poyosugi: folds
xxAlHixx: folds
Uncalled bet (7868) returned to 7SkYy
7SkYy collected 3500 from pot
7SkYy: doesn't show hand
*** SUMMARY ***
Total pot 3500 | Rake 0
Seat 1: ericpoker194 folded before Flop (didn't bet)
Seat 2: dimasiktuta folded before Flop (didn't bet)
Seat 4: D.Leonoff folded before Flop (didn't bet)
Seat 5: boensen1982 folded before Flop (didn't bet)
Seat 6: phpro folded before Flop (didn't bet)
Seat 7: 7SkYy (button) collected (3500)
Seat 8: Poyosugi (small blind) folded before Flop
Seat 9: xxAlHixx (big blind) folded before Flop


*********** # 134 **************
PokerStars Hand #257047136255: Tournament #3910307458, $0.98+$0.12 USD Hold'em No Limit - Level XVIII (600/1200) - 2025/07/22 12:24:22 ET
Table '3910307458 12' 9-max Seat #8 is the button
Seat 1: ericpoker194 (27797 in chips)
Seat 2: dimasiktuta (54668 in chips)
Seat 4: D.Leonoff (31480 in chips)
Seat 5: boensen1982 (32447 in chips)
Seat 6: phpro (21220 in chips)
Seat 7: 7SkYy (11368 in chips)
Seat 8: Poyosugi (20145 in chips)
Seat 9: xxAlHixx (9005 in chips)
ericpoker194: posts the ante 150
dimasiktuta: posts the ante 150
D.Leonoff: posts the ante 150
boensen1982: posts the ante 150
phpro: posts the ante 150
7SkYy: posts the ante 150
Poyosugi: posts the ante 150
xxAlHixx: posts the ante 150
xxAlHixx: posts small blind 600
ericpoker194: posts big blind 1200
*** HOLE CARDS ***
Dealt to phpro [7s 9h]
dimasiktuta: folds
D.Leonoff: folds
boensen1982: folds
phpro: folds
7SkYy: folds
Poyosugi: calls 1200
xxAlHixx: folds
ericpoker194: raises 26447 to 27647 and is all-in
Poyosugi: folds
Uncalled bet (26447) returned to ericpoker194
ericpoker194 collected 4200 from pot
ericpoker194: doesn't show hand
*** SUMMARY ***
Total pot 4200 | Rake 0
Seat 1: ericpoker194 (big blind) collected (4200)
Seat 2: dimasiktuta folded before Flop (didn't bet)
Seat 4: D.Leonoff folded before Flop (didn't bet)
Seat 5: boensen1982 folded before Flop (didn't bet)
Seat 6: phpro folded before Flop (didn't bet)
Seat 7: 7SkYy folded before Flop (didn't bet)
Seat 8: Poyosugi (button) folded before Flop
Seat 9: xxAlHixx (small blind) folded before Flop


*********** # 135 **************
PokerStars Hand #257047144339: Tournament #3910307458, $0.98+$0.12 USD Hold'em No Limit - Level XVIII (600/1200) - 2025/07/22 12:25:08 ET
Table '3910307458 12' 9-max Seat #9 is the button
Seat 1: ericpoker194 (30647 in chips)
Seat 2: dimasiktuta (54518 in chips)
Seat 4: D.Leonoff (31330 in chips)
Seat 5: boensen1982 (32297 in chips)
Seat 6: phpro (21070 in chips)
Seat 7: 7SkYy (11218 in chips)
Seat 8: Poyosugi (18795 in chips)
Seat 9: xxAlHixx (8255 in chips)
ericpoker194: posts the ante 150
dimasiktuta: posts the ante 150
D.Leonoff: posts the ante 150
boensen1982: posts the ante 150
phpro: posts the ante 150
7SkYy: posts the ante 150
Poyosugi: posts the ante 150
xxAlHixx: posts the ante 150
ericpoker194: posts small blind 600
dimasiktuta: posts big blind 1200
*** HOLE CARDS ***
Dealt to phpro [8s 8d]
D.Leonoff: folds
boensen1982: folds
phpro: folds
7SkYy: folds
Poyosugi: folds
xxAlHixx: folds
ericpoker194: calls 600
dimasiktuta: raises 2400 to 3600
ericpoker194: raises 26897 to 30497 and is all-in
dimasiktuta: folds
Uncalled bet (26897) returned to ericpoker194
ericpoker194 collected 8400 from pot
ericpoker194: doesn't show hand
*** SUMMARY ***
Total pot 8400 | Rake 0
Seat 1: ericpoker194 (small blind) collected (8400)
Seat 2: dimasiktuta (big blind) folded before Flop
Seat 4: D.Leonoff folded before Flop (didn't bet)
Seat 5: boensen1982 folded before Flop (didn't bet)
Seat 6: phpro folded before Flop (didn't bet)
Seat 7: 7SkYy folded before Flop (didn't bet)
Seat 8: Poyosugi folded before Flop (didn't bet)
Seat 9: xxAlHixx (button) folded before Flop (didn't bet)


*********** # 136 **************
PokerStars Hand #257047150063: Tournament #3910307458, $0.98+$0.12 USD Hold'em No Limit - Level XVIII (600/1200) - 2025/07/22 12:25:39 ET
Table '3910307458 12' 9-max Seat #1 is the button
Seat 1: ericpoker194 (35297 in chips)
Seat 2: dimasiktuta (50768 in chips)
Seat 4: D.Leonoff (31180 in chips)
Seat 5: boensen1982 (32147 in chips)
Seat 6: phpro (20920 in chips)
Seat 7: 7SkYy (11068 in chips)
Seat 8: Poyosugi (18645 in chips)
Seat 9: xxAlHixx (8105 in chips)
ericpoker194: posts the ante 150
dimasiktuta: posts the ante 150
D.Leonoff: posts the ante 150
boensen1982: posts the ante 150
phpro: posts the ante 150
7SkYy: posts the ante 150
Poyosugi: posts the ante 150
xxAlHixx: posts the ante 150
dimasiktuta: posts small blind 600
D.Leonoff: posts big blind 1200
*** HOLE CARDS ***
Dealt to phpro [5s Tc]
boensen1982: folds
phpro: folds
7SkYy: folds
Poyosugi: folds
xxAlHixx: folds
ericpoker194: folds
dimasiktuta: raises 3000 to 4200
D.Leonoff: folds
Uncalled bet (3000) returned to dimasiktuta
dimasiktuta collected 3600 from pot
dimasiktuta is sitting out
dimasiktuta: doesn't show hand
*** SUMMARY ***
Total pot 3600 | Rake 0
Seat 1: ericpoker194 (button) folded before Flop (didn't bet)
Seat 2: dimasiktuta (small blind) collected (3600)
Seat 4: D.Leonoff (big blind) folded before Flop
Seat 5: boensen1982 folded before Flop (didn't bet)
Seat 6: phpro folded before Flop (didn't bet)
Seat 7: 7SkYy folded before Flop (didn't bet)
Seat 8: Poyosugi folded before Flop (didn't bet)
Seat 9: xxAlHixx folded before Flop (didn't bet)


*********** # 137 **************
PokerStars Hand #257047157486: Tournament #3910307458, $0.98+$0.12 USD Hold'em No Limit - Level XVIII (600/1200) - 2025/07/22 12:26:21 ET
Table '3910307458 12' 9-max Seat #2 is the button
Seat 1: ericpoker194 (35147 in chips)
Seat 2: dimasiktuta (53018 in chips) is sitting out
Seat 4: D.Leonoff (29830 in chips)
Seat 5: boensen1982 (31997 in chips)
Seat 6: phpro (20770 in chips)
Seat 7: 7SkYy (10918 in chips)
Seat 8: Poyosugi (18495 in chips)
Seat 9: xxAlHixx (7955 in chips)
ericpoker194: posts the ante 150
dimasiktuta: posts the ante 150
D.Leonoff: posts the ante 150
boensen1982: posts the ante 150
phpro: posts the ante 150
7SkYy: posts the ante 150
Poyosugi: posts the ante 150
xxAlHixx: posts the ante 150
D.Leonoff: posts small blind 600
boensen1982: posts big blind 1200
*** HOLE CARDS ***
Dealt to phpro [7c 4s]
dimasiktuta has returned
phpro: folds
7SkYy: folds
Poyosugi: folds
xxAlHixx: folds
ericpoker194: folds
dimasiktuta: raises 1200 to 2400
D.Leonoff: folds
boensen1982: folds
Uncalled bet (1200) returned to dimasiktuta
dimasiktuta collected 4200 from pot
dimasiktuta: doesn't show hand
*** SUMMARY ***
Total pot 4200 | Rake 0
Seat 1: ericpoker194 folded before Flop (didn't bet)
Seat 2: dimasiktuta (button) collected (4200)
Seat 4: D.Leonoff (small blind) folded before Flop
Seat 5: boensen1982 (big blind) folded before Flop
Seat 6: phpro folded before Flop (didn't bet)
Seat 7: 7SkYy folded before Flop (didn't bet)
Seat 8: Poyosugi folded before Flop (didn't bet)
Seat 9: xxAlHixx folded before Flop (didn't bet)


*********** # 138 **************
PokerStars Hand #257047162848: Tournament #3910307458, $0.98+$0.12 USD Hold'em No Limit - Level XVIII (600/1200) - 2025/07/22 12:26:50 ET
Table '3910307458 12' 9-max Seat #4 is the button
Seat 1: ericpoker194 (34997 in chips)
Seat 2: dimasiktuta (55868 in chips)
Seat 4: D.Leonoff (29080 in chips)
Seat 5: boensen1982 (30647 in chips)
Seat 6: phpro (20620 in chips)
Seat 7: 7SkYy (10768 in chips)
Seat 8: Poyosugi (18345 in chips)
Seat 9: xxAlHixx (7805 in chips)
ericpoker194: posts the ante 150
dimasiktuta: posts the ante 150
D.Leonoff: posts the ante 150
boensen1982: posts the ante 150
phpro: posts the ante 150
7SkYy: posts the ante 150
Poyosugi: posts the ante 150
xxAlHixx: posts the ante 150
boensen1982: posts small blind 600
phpro: posts big blind 1200
*** HOLE CARDS ***
Dealt to phpro [Kh 9c]
7SkYy: folds
Poyosugi: folds
xxAlHixx: folds
ericpoker194: folds
dimasiktuta: folds
D.Leonoff: folds
boensen1982: folds
Uncalled bet (600) returned to phpro
phpro collected 2400 from pot
phpro: doesn't show hand
*** SUMMARY ***
Total pot 2400 | Rake 0
Seat 1: ericpoker194 folded before Flop (didn't bet)
Seat 2: dimasiktuta folded before Flop (didn't bet)
Seat 4: D.Leonoff (button) folded before Flop (didn't bet)
Seat 5: boensen1982 (small blind) folded before Flop
Seat 6: phpro (big blind) collected (2400)
Seat 7: 7SkYy folded before Flop (didn't bet)
Seat 8: Poyosugi folded before Flop (didn't bet)
Seat 9: xxAlHixx folded before Flop (didn't bet)


*********** # 139 **************
PokerStars Hand #257047166505: Tournament #3910307458, $0.98+$0.12 USD Hold'em No Limit - Level XVIII (600/1200) - 2025/07/22 12:27:11 ET
Table '3910307458 12' 9-max Seat #5 is the button
Seat 1: ericpoker194 (34847 in chips)
Seat 2: dimasiktuta (55718 in chips)
Seat 4: D.Leonoff (28930 in chips)
Seat 5: boensen1982 (29897 in chips)
Seat 6: phpro (22270 in chips)
Seat 7: 7SkYy (10618 in chips)
Seat 8: Poyosugi (18195 in chips)
Seat 9: xxAlHixx (7655 in chips)
ericpoker194: posts the ante 150
dimasiktuta: posts the ante 150
D.Leonoff: posts the ante 150
boensen1982: posts the ante 150
phpro: posts the ante 150
7SkYy: posts the ante 150
Poyosugi: posts the ante 150
xxAlHixx: posts the ante 150
phpro: posts small blind 600
7SkYy: posts big blind 1200
*** HOLE CARDS ***
Dealt to phpro [7h 7s]
Poyosugi: folds
xxAlHixx: folds
ericpoker194: folds
dimasiktuta: folds
D.Leonoff: folds
boensen1982: folds
phpro: raises 20920 to 22120 and is all-in
7SkYy: folds
Uncalled bet (20920) returned to phpro
phpro collected 3600 from pot
phpro: doesn't show hand
*** SUMMARY ***
Total pot 3600 | Rake 0
Seat 1: ericpoker194 folded before Flop (didn't bet)
Seat 2: dimasiktuta folded before Flop (didn't bet)
Seat 4: D.Leonoff folded before Flop (didn't bet)
Seat 5: boensen1982 (button) folded before Flop (didn't bet)
Seat 6: phpro (small blind) collected (3600)
Seat 7: 7SkYy (big blind) folded before Flop
Seat 8: Poyosugi folded before Flop (didn't bet)
Seat 9: xxAlHixx folded before Flop (didn't bet)


*********** # 140 **************
PokerStars Hand #257047170870: Tournament #3910307458, $0.98+$0.12 USD Hold'em No Limit - Level XVIII (600/1200) - 2025/07/22 12:27:35 ET
Table '3910307458 12' 9-max Seat #6 is the button
Seat 1: ericpoker194 (34697 in chips)
Seat 2: dimasiktuta (55568 in chips)
Seat 4: D.Leonoff (28780 in chips)
Seat 5: boensen1982 (29747 in chips)
Seat 6: phpro (24520 in chips)
Seat 7: 7SkYy (9268 in chips)
Seat 8: Poyosugi (18045 in chips)
Seat 9: xxAlHixx (7505 in chips)
ericpoker194: posts the ante 150
dimasiktuta: posts the ante 150
D.Leonoff: posts the ante 150
boensen1982: posts the ante 150
phpro: posts the ante 150
7SkYy: posts the ante 150
Poyosugi: posts the ante 150
xxAlHixx: posts the ante 150
7SkYy: posts small blind 600
Poyosugi: posts big blind 1200
*** HOLE CARDS ***
Dealt to phpro [Ts Jd]
xxAlHixx: folds
ericpoker194: folds
dimasiktuta: folds
D.Leonoff: raises 1440 to 2640
boensen1982: folds
phpro: folds
7SkYy: folds
Poyosugi: folds
Uncalled bet (1440) returned to D.Leonoff
D.Leonoff collected 4200 from pot
D.Leonoff: doesn't show hand
*** SUMMARY ***
Total pot 4200 | Rake 0
Seat 1: ericpoker194 folded before Flop (didn't bet)
Seat 2: dimasiktuta folded before Flop (didn't bet)
Seat 4: D.Leonoff collected (4200)
Seat 5: boensen1982 folded before Flop (didn't bet)
Seat 6: phpro (button) folded before Flop (didn't bet)
Seat 7: 7SkYy (small blind) folded before Flop
Seat 8: Poyosugi (big blind) folded before Flop
Seat 9: xxAlHixx folded before Flop (didn't bet)


*********** # 141 **************
PokerStars Hand #257047175783: Tournament #3910307458, $0.98+$0.12 USD Hold'em No Limit - Level XVIII (600/1200) - 2025/07/22 12:28:03 ET
Table '3910307458 12' 9-max Seat #7 is the button
Seat 1: ericpoker194 (34547 in chips)
Seat 2: dimasiktuta (55418 in chips)
Seat 4: D.Leonoff (31630 in chips)
Seat 5: boensen1982 (29597 in chips)
Seat 6: phpro (24370 in chips)
Seat 7: 7SkYy (8518 in chips)
Seat 8: Poyosugi (16695 in chips)
Seat 9: xxAlHixx (7355 in chips)
ericpoker194: posts the ante 150
dimasiktuta: posts the ante 150
D.Leonoff: posts the ante 150
boensen1982: posts the ante 150
phpro: posts the ante 150
7SkYy: posts the ante 150
Poyosugi: posts the ante 150
xxAlHixx: posts the ante 150
Poyosugi: posts small blind 600
xxAlHixx: posts big blind 1200
*** HOLE CARDS ***
Dealt to phpro [7c 4d]
ericpoker194: folds
dimasiktuta: raises 1200 to 2400
D.Leonoff: folds
boensen1982: folds
phpro: folds
7SkYy: folds
Poyosugi: folds
xxAlHixx: calls 1200
*** FLOP *** [3c 9s 3d]
xxAlHixx: checks
dimasiktuta: checks
*** TURN *** [3c 9s 3d] [7s]
xxAlHixx: bets 4290
dimasiktuta: folds
Uncalled bet (4290) returned to xxAlHixx
xxAlHixx collected 6600 from pot
xxAlHixx: doesn't show hand
*** SUMMARY ***
Total pot 6600 | Rake 0
Board [3c 9s 3d 7s]
Seat 1: ericpoker194 folded before Flop (didn't bet)
Seat 2: dimasiktuta folded on the Turn
Seat 4: D.Leonoff folded before Flop (didn't bet)
Seat 5: boensen1982 folded before Flop (didn't bet)
Seat 6: phpro folded before Flop (didn't bet)
Seat 7: 7SkYy (button) folded before Flop (didn't bet)
Seat 8: Poyosugi (small blind) folded before Flop
Seat 9: xxAlHixx (big blind) collected (6600)


*********** # 142 **************
PokerStars Hand #257047181636: Tournament #3910307458, $0.98+$0.12 USD Hold'em No Limit - Level XVIII (600/1200) - 2025/07/22 12:28:35 ET
Table '3910307458 12' 9-max Seat #8 is the button
Seat 1: ericpoker194 (34397 in chips)
Seat 2: dimasiktuta (52868 in chips)
Seat 4: D.Leonoff (31480 in chips)
Seat 5: boensen1982 (29447 in chips)
Seat 6: phpro (24220 in chips)
Seat 7: 7SkYy (8368 in chips)
Seat 8: Poyosugi (15945 in chips)
Seat 9: xxAlHixx (11405 in chips)
ericpoker194: posts the ante 150
dimasiktuta: posts the ante 150
D.Leonoff: posts the ante 150
boensen1982: posts the ante 150
phpro: posts the ante 150
7SkYy: posts the ante 150
Poyosugi: posts the ante 150
xxAlHixx: posts the ante 150
xxAlHixx: posts small blind 600
ericpoker194: posts big blind 1200
*** HOLE CARDS ***
Dealt to phpro [3c 7c]
dimasiktuta: folds
D.Leonoff: folds
boensen1982: folds
phpro: folds
7SkYy: raises 7018 to 8218 and is all-in
Poyosugi: folds
xxAlHixx: folds
ericpoker194: folds
Uncalled bet (7018) returned to 7SkYy
7SkYy collected 4200 from pot
7SkYy: doesn't show hand
*** SUMMARY ***
Total pot 4200 | Rake 0
Seat 1: ericpoker194 (big blind) folded before Flop
Seat 2: dimasiktuta folded before Flop (didn't bet)
Seat 4: D.Leonoff folded before Flop (didn't bet)
Seat 5: boensen1982 folded before Flop (didn't bet)
Seat 6: phpro folded before Flop (didn't bet)
Seat 7: 7SkYy collected (4200)
Seat 8: Poyosugi (button) folded before Flop (didn't bet)
Seat 9: xxAlHixx (small blind) folded before Flop


*********** # 143 **************
PokerStars Hand #257047185820: Tournament #3910307458, $0.98+$0.12 USD Hold'em No Limit - Level XVIII (600/1200) - 2025/07/22 12:28:59 ET
Table '3910307458 12' 9-max Seat #9 is the button
Seat 1: ericpoker194 (33047 in chips)
Seat 2: dimasiktuta (52718 in chips)
Seat 4: D.Leonoff (31330 in chips)
Seat 5: boensen1982 (29297 in chips)
Seat 6: phpro (24070 in chips)
Seat 7: 7SkYy (11218 in chips)
Seat 8: Poyosugi (15795 in chips)
Seat 9: xxAlHixx (10655 in chips)
ericpoker194: posts the ante 150
dimasiktuta: posts the ante 150
D.Leonoff: posts the ante 150
boensen1982: posts the ante 150
phpro: posts the ante 150
7SkYy: posts the ante 150
Poyosugi: posts the ante 150
xxAlHixx: posts the ante 150
ericpoker194: posts small blind 600
dimasiktuta: posts big blind 1200
*** HOLE CARDS ***
Dealt to phpro [Qh Ad]
D.Leonoff: folds
boensen1982: raises 1320 to 2520
phpro: calls 2520
7SkYy: folds
Poyosugi: folds
xxAlHixx: folds
ericpoker194: folds
dimasiktuta: folds
*** FLOP *** [5c 6h 9c]
boensen1982: bets 2640
phpro: calls 2640
*** TURN *** [5c 6h 9c] [Ac]
boensen1982: bets 6000
phpro: calls 6000
*** RIVER *** [5c 6h 9c Ac] [2d]
boensen1982: checks
phpro: checks
*** SHOW DOWN ***
boensen1982: shows [Kh Qs] (high card Ace)
phpro: shows [Qh Ad] (a pair of Aces)
phpro collected 25320 from pot
*** SUMMARY ***
Total pot 25320 | Rake 0
Board [5c 6h 9c Ac 2d]
Seat 1: ericpoker194 (small blind) folded before Flop
Seat 2: dimasiktuta (big blind) folded before Flop
Seat 4: D.Leonoff folded before Flop (didn't bet)
Seat 5: boensen1982 showed [Kh Qs] and lost with high card Ace
Seat 6: phpro showed [Qh Ad] and won (25320) with a pair of Aces
Seat 7: 7SkYy folded before Flop (didn't bet)
Seat 8: Poyosugi folded before Flop (didn't bet)
Seat 9: xxAlHixx (button) folded before Flop (didn't bet)


*********** # 144 **************
PokerStars Hand #257047196116: Tournament #3910307458, $0.98+$0.12 USD Hold'em No Limit - Level XVIII (600/1200) - 2025/07/22 12:29:57 ET
Table '3910307458 12' 9-max Seat #1 is the button
Seat 1: ericpoker194 (32297 in chips)
Seat 2: dimasiktuta (51368 in chips)
Seat 4: D.Leonoff (31180 in chips)
Seat 5: boensen1982 (17987 in chips)
Seat 6: phpro (38080 in chips)
Seat 7: 7SkYy (11068 in chips)
Seat 8: Poyosugi (15645 in chips)
Seat 9: xxAlHixx (10505 in chips)
ericpoker194: posts the ante 150
dimasiktuta: posts the ante 150
D.Leonoff: posts the ante 150
boensen1982: posts the ante 150
phpro: posts the ante 150
7SkYy: posts the ante 150
Poyosugi: posts the ante 150
xxAlHixx: posts the ante 150
dimasiktuta: posts small blind 600
D.Leonoff: posts big blind 1200
*** HOLE CARDS ***
Dealt to phpro [Jd 3d]
boensen1982: folds
phpro: folds
7SkYy: folds
Poyosugi: folds
xxAlHixx: folds
ericpoker194: raises 1200 to 2400
dimasiktuta: folds
D.Leonoff: folds
Uncalled bet (1200) returned to ericpoker194
ericpoker194 collected 4200 from pot
ericpoker194: doesn't show hand
*** SUMMARY ***
Total pot 4200 | Rake 0
Seat 1: ericpoker194 (button) collected (4200)
Seat 2: dimasiktuta (small blind) folded before Flop
Seat 4: D.Leonoff (big blind) folded before Flop
Seat 5: boensen1982 folded before Flop (didn't bet)
Seat 6: phpro folded before Flop (didn't bet)
Seat 7: 7SkYy folded before Flop (didn't bet)
Seat 8: Poyosugi folded before Flop (didn't bet)
Seat 9: xxAlHixx folded before Flop (didn't bet)


*********** # 145 **************
PokerStars Hand #257047201107: Tournament #3910307458, $0.98+$0.12 USD Hold'em No Limit - Level XVIII (600/1200) - 2025/07/22 12:30:23 ET
Table '3910307458 12' 9-max Seat #2 is the button
Seat 1: ericpoker194 (35147 in chips)
Seat 2: dimasiktuta (50618 in chips)
Seat 4: D.Leonoff (29830 in chips)
Seat 5: boensen1982 (17837 in chips)
Seat 6: phpro (37930 in chips)
Seat 7: 7SkYy (10918 in chips)
Seat 8: Poyosugi (15495 in chips)
Seat 9: xxAlHixx (10355 in chips)
ericpoker194: posts the ante 150
dimasiktuta: posts the ante 150
D.Leonoff: posts the ante 150
boensen1982: posts the ante 150
phpro: posts the ante 150
7SkYy: posts the ante 150
Poyosugi: posts the ante 150
xxAlHixx: posts the ante 150
D.Leonoff: posts small blind 600
boensen1982: posts big blind 1200
*** HOLE CARDS ***
Dealt to phpro [4h Jd]
phpro: folds
7SkYy: folds
Poyosugi: folds
xxAlHixx: folds
ericpoker194: raises 1200 to 2400
dimasiktuta: folds
D.Leonoff: folds
boensen1982: folds
Uncalled bet (1200) returned to ericpoker194
ericpoker194 collected 4200 from pot
ericpoker194: doesn't show hand
*** SUMMARY ***
Total pot 4200 | Rake 0
Seat 1: ericpoker194 collected (4200)
Seat 2: dimasiktuta (button) folded before Flop (didn't bet)
Seat 4: D.Leonoff (small blind) folded before Flop
Seat 5: boensen1982 (big blind) folded before Flop
Seat 6: phpro folded before Flop (didn't bet)
Seat 7: 7SkYy folded before Flop (didn't bet)
Seat 8: Poyosugi folded before Flop (didn't bet)
Seat 9: xxAlHixx folded before Flop (didn't bet)


*********** # 146 **************
PokerStars Hand #257047211101: Tournament #3910307458, $0.98+$0.12 USD Hold'em No Limit - Level XVIII (600/1200) - 2025/07/22 12:31:19 ET
Table '3910307458 12' 9-max Seat #4 is the button
Seat 1: ericpoker194 (37997 in chips)
Seat 2: dimasiktuta (50468 in chips)
Seat 4: D.Leonoff (29080 in chips)
Seat 5: boensen1982 (16487 in chips)
Seat 6: phpro (37780 in chips)
Seat 7: 7SkYy (10768 in chips)
Seat 8: Poyosugi (15345 in chips)
Seat 9: xxAlHixx (10205 in chips)
ericpoker194: posts the ante 150
dimasiktuta: posts the ante 150
D.Leonoff: posts the ante 150
boensen1982: posts the ante 150
phpro: posts the ante 150
7SkYy: posts the ante 150
Poyosugi: posts the ante 150
xxAlHixx: posts the ante 150
boensen1982: posts small blind 600
phpro: posts big blind 1200
*** HOLE CARDS ***
Dealt to phpro [Td As]
7SkYy: folds
Poyosugi: folds
xxAlHixx: folds
ericpoker194: raises 1200 to 2400
dimasiktuta: folds
D.Leonoff: folds
boensen1982: folds
phpro: calls 1200
*** FLOP *** [6d 8h 2h]
phpro: checks
ericpoker194: checks
*** TURN *** [6d 8h 2h] [6h]
phpro: checks
ericpoker194: checks
*** RIVER *** [6d 8h 2h 6h] [8s]
phpro: checks
ericpoker194: checks
*** SHOW DOWN ***
phpro: shows [Td As] (two pair, Eights and Sixes)
ericpoker194: mucks hand
phpro collected 6600 from pot
*** SUMMARY ***
Total pot 6600 | Rake 0
Board [6d 8h 2h 6h 8s]
Seat 1: ericpoker194 mucked [9c Ks]
Seat 2: dimasiktuta folded before Flop (didn't bet)
Seat 4: D.Leonoff (button) folded before Flop (didn't bet)
Seat 5: boensen1982 (small blind) folded before Flop
Seat 6: phpro (big blind) showed [Td As] and won (6600) with two pair, Eights and Sixes
Seat 7: 7SkYy folded before Flop (didn't bet)
Seat 8: Poyosugi folded before Flop (didn't bet)
Seat 9: xxAlHixx folded before Flop (didn't bet)


*********** # 147 **************
PokerStars Hand #257047221838: Tournament #3910307458, $0.98+$0.12 USD Hold'em No Limit - Level XVIII (600/1200) - 2025/07/22 12:32:19 ET
Table '3910307458 12' 9-max Seat #5 is the button
Seat 1: ericpoker194 (35447 in chips)
Seat 2: dimasiktuta (50318 in chips)
Seat 4: D.Leonoff (28930 in chips)
Seat 5: boensen1982 (15737 in chips)
Seat 6: phpro (41830 in chips)
Seat 7: 7SkYy (10618 in chips)
Seat 8: Poyosugi (15195 in chips)
Seat 9: xxAlHixx (10055 in chips)
ericpoker194: posts the ante 150
dimasiktuta: posts the ante 150
D.Leonoff: posts the ante 150
boensen1982: posts the ante 150
phpro: posts the ante 150
7SkYy: posts the ante 150
Poyosugi: posts the ante 150
xxAlHixx: posts the ante 150
phpro: posts small blind 600
7SkYy: posts big blind 1200
*** HOLE CARDS ***
Dealt to phpro [9d Jd]
Poyosugi: folds
xxAlHixx: folds
ericpoker194: folds
dimasiktuta: raises 1200 to 2400
D.Leonoff: folds
boensen1982: folds
phpro: folds
7SkYy: folds
Uncalled bet (1200) returned to dimasiktuta
dimasiktuta collected 4200 from pot
dimasiktuta: doesn't show hand
*** SUMMARY ***
Total pot 4200 | Rake 0
Seat 1: ericpoker194 folded before Flop (didn't bet)
Seat 2: dimasiktuta collected (4200)
Seat 4: D.Leonoff folded before Flop (didn't bet)
Seat 5: boensen1982 (button) folded before Flop (didn't bet)
Seat 6: phpro (small blind) folded before Flop
Seat 7: 7SkYy (big blind) folded before Flop
Seat 8: Poyosugi folded before Flop (didn't bet)
Seat 9: xxAlHixx folded before Flop (didn't bet)


*********** # 148 **************
PokerStars Hand #257047226776: Tournament #3910307458, $0.98+$0.12 USD Hold'em No Limit - Level XVIII (600/1200) - 2025/07/22 12:32:46 ET
Table '3910307458 12' 9-max Seat #6 is the button
Seat 1: ericpoker194 (35297 in chips)
Seat 2: dimasiktuta (53168 in chips)
Seat 4: D.Leonoff (28780 in chips)
Seat 5: boensen1982 (15587 in chips)
Seat 6: phpro (41080 in chips)
Seat 7: 7SkYy (9268 in chips)
Seat 8: Poyosugi (15045 in chips)
Seat 9: xxAlHixx (9905 in chips)
ericpoker194: posts the ante 150
dimasiktuta: posts the ante 150
D.Leonoff: posts the ante 150
boensen1982: posts the ante 150
phpro: posts the ante 150
7SkYy: posts the ante 150
Poyosugi: posts the ante 150
xxAlHixx: posts the ante 150
7SkYy: posts small blind 600
Poyosugi: posts big blind 1200
*** HOLE CARDS ***
Dealt to phpro [3c Ah]
xxAlHixx: folds
ericpoker194: folds
dimasiktuta: raises 1200 to 2400
D.Leonoff: folds
boensen1982: folds
phpro: folds
7SkYy: folds
Poyosugi: folds
Uncalled bet (1200) returned to dimasiktuta
dimasiktuta collected 4200 from pot
dimasiktuta: doesn't show hand
*** SUMMARY ***
Total pot 4200 | Rake 0
Seat 1: ericpoker194 folded before Flop (didn't bet)
Seat 2: dimasiktuta collected (4200)
Seat 4: D.Leonoff folded before Flop (didn't bet)
Seat 5: boensen1982 folded before Flop (didn't bet)
Seat 6: phpro (button) folded before Flop (didn't bet)
Seat 7: 7SkYy (small blind) folded before Flop
Seat 8: Poyosugi (big blind) folded before Flop
Seat 9: xxAlHixx folded before Flop (didn't bet)


*********** # 149 **************
PokerStars Hand #257047236880: Tournament #3910307458, $0.98+$0.12 USD Hold'em No Limit - Level XVIII (600/1200) - 2025/07/22 12:33:42 ET
Table '3910307458 5' 9-max Seat #4 is the button
Seat 1: stoner.fuzz6 (12600 in chips)
Seat 2: Mokka90 (24559 in chips)
Seat 3: FelipeCSilva (48604 in chips)
Seat 4: GroggRoger (28582 in chips)
Seat 5: phpro (40930 in chips) out of hand (moved from another table into small blind)
Seat 6: oldyellowbricks (55702 in chips)
Seat 7: PhatAction09 (41480 in chips)
Seat 8: Nikol855 (886 in chips) is sitting out
Seat 9: bayodelic2703 (27511 in chips)
phpro will be allowed to play after the button
stoner.fuzz6: posts the ante 150
Mokka90: posts the ante 150
FelipeCSilva: posts the ante 150
GroggRoger: posts the ante 150
oldyellowbricks: posts the ante 150
PhatAction09: posts the ante 150
Nikol855: posts the ante 150
bayodelic2703: posts the ante 150
oldyellowbricks: posts small blind 600
PhatAction09: posts big blind 1200
*** HOLE CARDS ***
Nikol855: folds
bayodelic2703: folds
stoner.fuzz6: folds
Mokka90: folds
FelipeCSilva: folds
GroggRoger: folds
oldyellowbricks: raises 2400 to 3600
PhatAction09: folds
Uncalled bet (2400) returned to oldyellowbricks
oldyellowbricks collected 3600 from pot
oldyellowbricks: doesn't show hand
*** SUMMARY ***
Total pot 3600 | Rake 0
Seat 1: stoner.fuzz6 folded before Flop (didn't bet)
Seat 2: Mokka90 folded before Flop (didn't bet)
Seat 3: FelipeCSilva folded before Flop (didn't bet)
Seat 4: GroggRoger (button) folded before Flop (didn't bet)
Seat 6: oldyellowbricks (small blind) collected (3600)
Seat 7: PhatAction09 (big blind) folded before Flop
Seat 8: Nikol855 folded before Flop (didn't bet)
Seat 9: bayodelic2703 folded before Flop (didn't bet)


*********** # 150 **************
PokerStars Hand #257047244864: Tournament #3910307458, $0.98+$0.12 USD Hold'em No Limit - Level XIX (700/1400) - 2025/07/22 12:34:26 ET
Table '3910307458 5' 9-max Seat #6 is the button
Seat 1: stoner.fuzz6 (12450 in chips)
Seat 2: Mokka90 (24409 in chips)
Seat 3: FelipeCSilva (48454 in chips)
Seat 4: GroggRoger (28432 in chips)
Seat 5: phpro (40930 in chips)
Seat 6: oldyellowbricks (57952 in chips)
Seat 7: PhatAction09 (40130 in chips)
Seat 8: Nikol855 (736 in chips) is sitting out
Seat 9: bayodelic2703 (27361 in chips)
stoner.fuzz6: posts the ante 175
Mokka90: posts the ante 175
FelipeCSilva: posts the ante 175
GroggRoger: posts the ante 175
phpro: posts the ante 175
oldyellowbricks: posts the ante 175
PhatAction09: posts the ante 175
Nikol855: posts the ante 175
bayodelic2703: posts the ante 175
PhatAction09: posts small blind 700
Nikol855: posts big blind 561 and is all-in
*** HOLE CARDS ***
Dealt to phpro [6c 6d]
bayodelic2703: folds
stoner.fuzz6: folds
Mokka90: folds
FelipeCSilva: folds
GroggRoger: raises 3500 to 4200
phpro: folds
oldyellowbricks: folds
PhatAction09: folds
Nikol855: folds
Uncalled bet (3500) returned to GroggRoger
GroggRoger collected 3536 from pot
Nikol855 finished the tournament in 27th place and received $1.75.
GroggRoger: doesn't show hand
*** SUMMARY ***
Total pot 3536 | Rake 0
Seat 1: stoner.fuzz6 folded before Flop (didn't bet)
Seat 2: Mokka90 folded before Flop (didn't bet)
Seat 3: FelipeCSilva folded before Flop (didn't bet)
Seat 4: GroggRoger collected (3536)
Seat 5: phpro folded before Flop (didn't bet)
Seat 6: oldyellowbricks (button) folded before Flop (didn't bet)
Seat 7: PhatAction09 (small blind) folded before Flop
Seat 8: Nikol855 (big blind) folded before Flop
Seat 9: bayodelic2703 folded before Flop (didn't bet)


*********** # 151 **************
PokerStars Hand #257047249465: Tournament #3910307458, $0.98+$0.12 USD Hold'em No Limit - Level XIX (700/1400) - 2025/07/22 12:34:50 ET
Table '3910307458 5' 9-max Seat #7 is the button
Seat 1: stoner.fuzz6 (12275 in chips)
Seat 2: Mokka90 (24234 in chips)
Seat 3: FelipeCSilva (48279 in chips)
Seat 4: GroggRoger (31093 in chips)
Seat 5: phpro (40755 in chips)
Seat 6: oldyellowbricks (57777 in chips)
Seat 7: PhatAction09 (39255 in chips)
Seat 9: bayodelic2703 (27186 in chips)
stoner.fuzz6: posts the ante 175
Mokka90: posts the ante 175
FelipeCSilva: posts the ante 175
GroggRoger: posts the ante 175
phpro: posts the ante 175
oldyellowbricks: posts the ante 175
PhatAction09: posts the ante 175
bayodelic2703: posts the ante 175
bayodelic2703: posts small blind 700
stoner.fuzz6: posts big blind 1400
*** HOLE CARDS ***
Dealt to phpro [Ts 4h]
Mokka90: folds
FelipeCSilva: folds
GroggRoger: folds
phpro: folds
oldyellowbricks: raises 1400 to 2800
PhatAction09: folds
bayodelic2703: folds
stoner.fuzz6: folds
Uncalled bet (1400) returned to oldyellowbricks
oldyellowbricks collected 4900 from pot
oldyellowbricks: doesn't show hand
*** SUMMARY ***
Total pot 4900 | Rake 0
Seat 1: stoner.fuzz6 (big blind) folded before Flop
Seat 2: Mokka90 folded before Flop (didn't bet)
Seat 3: FelipeCSilva folded before Flop (didn't bet)
Seat 4: GroggRoger folded before Flop (didn't bet)
Seat 5: phpro folded before Flop (didn't bet)
Seat 6: oldyellowbricks collected (4900)
Seat 7: PhatAction09 (button) folded before Flop (didn't bet)
Seat 9: bayodelic2703 (small blind) folded before Flop


*********** # 152 **************
PokerStars Hand #257047255713: Tournament #3910307458, $0.98+$0.12 USD Hold'em No Limit - Level XIX (700/1400) - 2025/07/22 12:35:24 ET
Table '3910307458 5' 9-max Seat #9 is the button
Seat 1: stoner.fuzz6 (10700 in chips)
Seat 2: Mokka90 (24059 in chips)
Seat 3: FelipeCSilva (48104 in chips)
Seat 4: GroggRoger (30918 in chips)
Seat 5: phpro (40580 in chips)
Seat 6: oldyellowbricks (61102 in chips)
Seat 7: PhatAction09 (39080 in chips)
Seat 9: bayodelic2703 (26311 in chips)
stoner.fuzz6: posts the ante 175
Mokka90: posts the ante 175
FelipeCSilva: posts the ante 175
GroggRoger: posts the ante 175
phpro: posts the ante 175
oldyellowbricks: posts the ante 175
PhatAction09: posts the ante 175
bayodelic2703: posts the ante 175
stoner.fuzz6: posts small blind 700
Mokka90: posts big blind 1400
*** HOLE CARDS ***
Dealt to phpro [Qd 3h]
FelipeCSilva: folds
GroggRoger: raises 2800 to 4200
phpro: folds
oldyellowbricks: folds
PhatAction09: folds
bayodelic2703: folds
stoner.fuzz6: folds
Mokka90: folds
Uncalled bet (2800) returned to GroggRoger
GroggRoger collected 4900 from pot
GroggRoger: doesn't show hand
*** SUMMARY ***
Total pot 4900 | Rake 0
Seat 1: stoner.fuzz6 (small blind) folded before Flop
Seat 2: Mokka90 (big blind) folded before Flop
Seat 3: FelipeCSilva folded before Flop (didn't bet)
Seat 4: GroggRoger collected (4900)
Seat 5: phpro folded before Flop (didn't bet)
Seat 6: oldyellowbricks folded before Flop (didn't bet)
Seat 7: PhatAction09 folded before Flop (didn't bet)
Seat 9: bayodelic2703 (button) folded before Flop (didn't bet)


*********** # 153 **************
PokerStars Hand #257047259625: Tournament #3910307458, $0.98+$0.12 USD Hold'em No Limit - Level XIX (700/1400) - 2025/07/22 12:35:46 ET
Table '3910307458 5' 9-max Seat #1 is the button
Seat 1: stoner.fuzz6 (9825 in chips)
Seat 2: Mokka90 (22484 in chips)
Seat 3: FelipeCSilva (47929 in chips)
Seat 4: GroggRoger (34243 in chips)
Seat 5: phpro (40405 in chips)
Seat 6: oldyellowbricks (60927 in chips)
Seat 7: PhatAction09 (38905 in chips)
Seat 9: bayodelic2703 (26136 in chips)
stoner.fuzz6: posts the ante 175
Mokka90: posts the ante 175
FelipeCSilva: posts the ante 175
GroggRoger: posts the ante 175
phpro: posts the ante 175
oldyellowbricks: posts the ante 175
PhatAction09: posts the ante 175
bayodelic2703: posts the ante 175
Mokka90: posts small blind 700
FelipeCSilva: posts big blind 1400
*** HOLE CARDS ***
Dealt to phpro [8c 3c]
GroggRoger: folds
phpro: folds
oldyellowbricks: raises 1400 to 2800
PhatAction09: folds
bayodelic2703: calls 2800
stoner.fuzz6: folds
Mokka90: folds
FelipeCSilva: calls 1400
*** FLOP *** [4s 9d Qs]
FelipeCSilva: checks
oldyellowbricks: checks
bayodelic2703: checks
*** TURN *** [4s 9d Qs] [5d]
FelipeCSilva: checks
oldyellowbricks: bets 5600
bayodelic2703: folds
FelipeCSilva: folds
Uncalled bet (5600) returned to oldyellowbricks
oldyellowbricks collected 10500 from pot
oldyellowbricks: doesn't show hand
*** SUMMARY ***
Total pot 10500 | Rake 0
Board [4s 9d Qs 5d]
Seat 1: stoner.fuzz6 (button) folded before Flop (didn't bet)
Seat 2: Mokka90 (small blind) folded before Flop
Seat 3: FelipeCSilva (big blind) folded on the Turn
Seat 4: GroggRoger folded before Flop (didn't bet)
Seat 5: phpro folded before Flop (didn't bet)
Seat 6: oldyellowbricks collected (10500)
Seat 7: PhatAction09 folded before Flop (didn't bet)
Seat 9: bayodelic2703 folded on the Turn


*********** # 154 **************
PokerStars Hand #257047276860: Tournament #3910307458, $0.98+$0.12 USD Hold'em No Limit - Level XIX (700/1400) - 2025/07/22 12:37:21 ET
Table '3910307458 5' 9-max Seat #2 is the button
Seat 1: stoner.fuzz6 (9650 in chips)
Seat 2: Mokka90 (21609 in chips)
Seat 3: FelipeCSilva (44954 in chips)
Seat 4: GroggRoger (34068 in chips)
Seat 5: phpro (40230 in chips)
Seat 6: oldyellowbricks (68452 in chips)
Seat 7: PhatAction09 (38730 in chips)
Seat 9: bayodelic2703 (23161 in chips)
stoner.fuzz6: posts the ante 175
Mokka90: posts the ante 175
FelipeCSilva: posts the ante 175
GroggRoger: posts the ante 175
phpro: posts the ante 175
oldyellowbricks: posts the ante 175
PhatAction09: posts the ante 175
bayodelic2703: posts the ante 175
FelipeCSilva: posts small blind 700
GroggRoger: posts big blind 1400
*** HOLE CARDS ***
Dealt to phpro [4h 2s]
phpro: folds
oldyellowbricks: raises 1400 to 2800
PhatAction09: folds
bayodelic2703: folds
stoner.fuzz6: folds
Mokka90: folds
FelipeCSilva: raises 8400 to 11200
GroggRoger: folds
oldyellowbricks: folds
Uncalled bet (8400) returned to FelipeCSilva
FelipeCSilva collected 8400 from pot
FelipeCSilva: doesn't show hand
*** SUMMARY ***
Total pot 8400 | Rake 0
Seat 1: stoner.fuzz6 folded before Flop (didn't bet)
Seat 2: Mokka90 (button) folded before Flop (didn't bet)
Seat 3: FelipeCSilva (small blind) collected (8400)
Seat 4: GroggRoger (big blind) folded before Flop
Seat 5: phpro folded before Flop (didn't bet)
Seat 6: oldyellowbricks folded before Flop
Seat 7: PhatAction09 folded before Flop (didn't bet)
Seat 9: bayodelic2703 folded before Flop (didn't bet)


*********** # 155 **************
PokerStars Hand #257047282699: Tournament #3910307458, $0.98+$0.12 USD Hold'em No Limit - Level XIX (700/1400) - 2025/07/22 12:37:54 ET
Table '3910307458 5' 9-max Seat #3 is the button
Seat 1: stoner.fuzz6 (9475 in chips)
Seat 2: Mokka90 (21434 in chips)
Seat 3: FelipeCSilva (50379 in chips)
Seat 4: GroggRoger (32493 in chips)
Seat 5: phpro (40055 in chips)
Seat 6: oldyellowbricks (65477 in chips)
Seat 7: PhatAction09 (38555 in chips)
Seat 9: bayodelic2703 (22986 in chips)
stoner.fuzz6: posts the ante 175
Mokka90: posts the ante 175
FelipeCSilva: posts the ante 175
GroggRoger: posts the ante 175
phpro: posts the ante 175
oldyellowbricks: posts the ante 175
PhatAction09: posts the ante 175
bayodelic2703: posts the ante 175
GroggRoger: posts small blind 700
phpro: posts big blind 1400
*** HOLE CARDS ***
Dealt to phpro [Td 6c]
oldyellowbricks: folds
PhatAction09: folds
bayodelic2703: folds
stoner.fuzz6: folds
Mokka90: folds
FelipeCSilva: raises 1400 to 2800
GroggRoger: folds
phpro: calls 1400
*** FLOP *** [7d 2d 8s]
phpro: checks
FelipeCSilva: checks
*** TURN *** [7d 2d 8s] [Qh]
phpro: checks
FelipeCSilva: bets 3850
phpro: folds
Uncalled bet (3850) returned to FelipeCSilva
FelipeCSilva collected 7700 from pot
FelipeCSilva: doesn't show hand
*** SUMMARY ***
Total pot 7700 | Rake 0
Board [7d 2d 8s Qh]
Seat 1: stoner.fuzz6 folded before Flop (didn't bet)
Seat 2: Mokka90 folded before Flop (didn't bet)
Seat 3: FelipeCSilva (button) collected (7700)
Seat 4: GroggRoger (small blind) folded before Flop
Seat 5: phpro (big blind) folded on the Turn
Seat 6: oldyellowbricks folded before Flop (didn't bet)
Seat 7: PhatAction09 folded before Flop (didn't bet)
Seat 9: bayodelic2703 folded before Flop (didn't bet)


*********** # 156 **************
PokerStars Hand #257047292731: Tournament #3910307458, $0.98+$0.12 USD Hold'em No Limit - Level XIX (700/1400) - 2025/07/22 12:38:49 ET
Table '3910307458 5' 9-max Seat #4 is the button
Seat 1: stoner.fuzz6 (9300 in chips)
Seat 2: Mokka90 (21259 in chips)
Seat 3: FelipeCSilva (55104 in chips)
Seat 4: GroggRoger (31618 in chips)
Seat 5: phpro (37080 in chips)
Seat 6: oldyellowbricks (65302 in chips)
Seat 7: PhatAction09 (38380 in chips)
Seat 9: bayodelic2703 (22811 in chips)
stoner.fuzz6: posts the ante 175
Mokka90: posts the ante 175
FelipeCSilva: posts the ante 175
GroggRoger: posts the ante 175
phpro: posts the ante 175
oldyellowbricks: posts the ante 175
PhatAction09: posts the ante 175
bayodelic2703: posts the ante 175
phpro: posts small blind 700
oldyellowbricks: posts big blind 1400
*** HOLE CARDS ***
Dealt to phpro [2d 7h]
PhatAction09: folds
bayodelic2703: folds
stoner.fuzz6: folds
Mokka90: folds
FelipeCSilva: raises 1400 to 2800
GroggRoger: folds
phpro: folds
oldyellowbricks: calls 1400
*** FLOP *** [3c 9s Ad]
oldyellowbricks: checks
FelipeCSilva: bets 2541
oldyellowbricks: calls 2541
*** TURN *** [3c 9s Ad] [5s]
oldyellowbricks: checks
FelipeCSilva: checks
*** RIVER *** [3c 9s Ad 5s] [3h]
oldyellowbricks: bets 4200
FelipeCSilva: folds
Uncalled bet (4200) returned to oldyellowbricks
oldyellowbricks collected 12782 from pot
oldyellowbricks: doesn't show hand
*** SUMMARY ***
Total pot 12782 | Rake 0
Board [3c 9s Ad 5s 3h]
Seat 1: stoner.fuzz6 folded before Flop (didn't bet)
Seat 2: Mokka90 folded before Flop (didn't bet)
Seat 3: FelipeCSilva folded on the River
Seat 4: GroggRoger (button) folded before Flop (didn't bet)
Seat 5: phpro (small blind) folded before Flop
Seat 6: oldyellowbricks (big blind) collected (12782)
Seat 7: PhatAction09 folded before Flop (didn't bet)
Seat 9: bayodelic2703 folded before Flop (didn't bet)


*********** # 157 **************
PokerStars Hand #257047302383: Tournament #3910307458, $0.98+$0.12 USD Hold'em No Limit - Level XIX (700/1400) - 2025/07/22 12:39:42 ET
Table '3910307458 5' 9-max Seat #5 is the button
Seat 1: stoner.fuzz6 (9125 in chips)
Seat 2: Mokka90 (21084 in chips)
Seat 3: FelipeCSilva (49588 in chips)
Seat 4: GroggRoger (31443 in chips)
Seat 5: phpro (36205 in chips)
Seat 6: oldyellowbricks (72568 in chips)
Seat 7: PhatAction09 (38205 in chips)
Seat 9: bayodelic2703 (22636 in chips)
stoner.fuzz6: posts the ante 175
Mokka90: posts the ante 175
FelipeCSilva: posts the ante 175
GroggRoger: posts the ante 175
phpro: posts the ante 175
oldyellowbricks: posts the ante 175
PhatAction09: posts the ante 175
bayodelic2703: posts the ante 175
oldyellowbricks: posts small blind 700
PhatAction09: posts big blind 1400
*** HOLE CARDS ***
Dealt to phpro [2c 5c]
bayodelic2703: folds
stoner.fuzz6: folds
Mokka90: folds
FelipeCSilva: folds
GroggRoger: folds
phpro: raises 1400 to 2800
oldyellowbricks: folds
PhatAction09: calls 1400
*** FLOP *** [7s Ks 8h]
PhatAction09: checks
phpro: bets 2541
PhatAction09: folds
Uncalled bet (2541) returned to phpro
phpro collected 7700 from pot
phpro: doesn't show hand
*** SUMMARY ***
Total pot 7700 | Rake 0
Board [7s Ks 8h]
Seat 1: stoner.fuzz6 folded before Flop (didn't bet)
Seat 2: Mokka90 folded before Flop (didn't bet)
Seat 3: FelipeCSilva folded before Flop (didn't bet)
Seat 4: GroggRoger folded before Flop (didn't bet)
Seat 5: phpro (button) collected (7700)
Seat 6: oldyellowbricks (small blind) folded before Flop
Seat 7: PhatAction09 (big blind) folded on the Flop
Seat 9: bayodelic2703 folded before Flop (didn't bet)


*********** # 158 **************
PokerStars Hand #257047310208: Tournament #3910307458, $0.98+$0.12 USD Hold'em No Limit - Level XIX (700/1400) - 2025/07/22 12:40:25 ET
Table '3910307458 5' 9-max Seat #6 is the button
Seat 1: stoner.fuzz6 (8950 in chips)
Seat 2: Mokka90 (20909 in chips)
Seat 3: FelipeCSilva (49413 in chips)
Seat 4: GroggRoger (31268 in chips)
Seat 5: phpro (40930 in chips)
Seat 6: oldyellowbricks (71693 in chips)
Seat 7: PhatAction09 (35230 in chips)
Seat 9: bayodelic2703 (22461 in chips)
stoner.fuzz6: posts the ante 175
Mokka90: posts the ante 175
FelipeCSilva: posts the ante 175
GroggRoger: posts the ante 175
phpro: posts the ante 175
oldyellowbricks: posts the ante 175
PhatAction09: posts the ante 175
bayodelic2703: posts the ante 175
PhatAction09: posts small blind 700
bayodelic2703: posts big blind 1400
*** HOLE CARDS ***
Dealt to phpro [8h 3s]
stoner.fuzz6: folds
Mokka90: folds
FelipeCSilva: folds
GroggRoger: folds
phpro: folds
oldyellowbricks: raises 1400 to 2800
PhatAction09: folds
bayodelic2703: calls 1400
*** FLOP *** [Jd 2h 7s]
bayodelic2703: checks
oldyellowbricks: bets 2541
bayodelic2703: calls 2541
*** TURN *** [Jd 2h 7s] [9c]
bayodelic2703: checks
oldyellowbricks: checks
*** RIVER *** [Jd 2h 7s 9c] [8d]
bayodelic2703: bets 2800
oldyellowbricks: calls 2800
*** SHOW DOWN ***
bayodelic2703: shows [7c 6s] (a pair of Sevens)
oldyellowbricks: shows [8c 6c] (a pair of Eights)
oldyellowbricks collected 18382 from pot
*** SUMMARY ***
Total pot 18382 | Rake 0
Board [Jd 2h 7s 9c 8d]
Seat 1: stoner.fuzz6 folded before Flop (didn't bet)
Seat 2: Mokka90 folded before Flop (didn't bet)
Seat 3: FelipeCSilva folded before Flop (didn't bet)
Seat 4: GroggRoger folded before Flop (didn't bet)
Seat 5: phpro folded before Flop (didn't bet)
Seat 6: oldyellowbricks (button) showed [8c 6c] and won (18382) with a pair of Eights
Seat 7: PhatAction09 (small blind) folded before Flop
Seat 9: bayodelic2703 (big blind) showed [7c 6s] and lost with a pair of Sevens


*********** # 159 **************
PokerStars Hand #257047319464: Tournament #3910307458, $0.98+$0.12 USD Hold'em No Limit - Level XIX (700/1400) - 2025/07/22 12:41:16 ET
Table '3910307458 5' 9-max Seat #7 is the button
Seat 1: stoner.fuzz6 (8775 in chips)
Seat 2: Mokka90 (20734 in chips)
Seat 3: FelipeCSilva (49238 in chips)
Seat 4: GroggRoger (31093 in chips)
Seat 5: phpro (40755 in chips)
Seat 6: oldyellowbricks (81759 in chips)
Seat 7: PhatAction09 (34355 in chips)
Seat 9: bayodelic2703 (14145 in chips)
stoner.fuzz6: posts the ante 175
Mokka90: posts the ante 175
FelipeCSilva: posts the ante 175
GroggRoger: posts the ante 175
phpro: posts the ante 175
oldyellowbricks: posts the ante 175
PhatAction09: posts the ante 175
bayodelic2703: posts the ante 175
bayodelic2703: posts small blind 700
stoner.fuzz6: posts big blind 1400
*** HOLE CARDS ***
Dealt to phpro [7s 4h]
Mokka90: folds
FelipeCSilva: raises 1400 to 2800
GroggRoger: folds
phpro: folds
oldyellowbricks: raises 5600 to 8400
PhatAction09: raises 25780 to 34180 and is all-in
bayodelic2703: folds
stoner.fuzz6: folds
FelipeCSilva: folds
oldyellowbricks: folds
Uncalled bet (25780) returned to PhatAction09
PhatAction09 collected 23100 from pot
PhatAction09: doesn't show hand
*** SUMMARY ***
Total pot 23100 | Rake 0
Seat 1: stoner.fuzz6 (big blind) folded before Flop
Seat 2: Mokka90 folded before Flop (didn't bet)
Seat 3: FelipeCSilva folded before Flop
Seat 4: GroggRoger folded before Flop (didn't bet)
Seat 5: phpro folded before Flop (didn't bet)
Seat 6: oldyellowbricks folded before Flop
Seat 7: PhatAction09 (button) collected (23100)
Seat 9: bayodelic2703 (small blind) folded before Flop


*********** # 160 **************
PokerStars Hand #257047331649: Tournament #3910307458, $0.98+$0.12 USD Hold'em No Limit - Level XIX (700/1400) - 2025/07/22 12:42:23 ET
Table '3910307458 5' 9-max Seat #9 is the button
Seat 1: stoner.fuzz6 (7200 in chips)
Seat 2: Mokka90 (20559 in chips)
Seat 3: FelipeCSilva (46263 in chips)
Seat 4: GroggRoger (30918 in chips)
Seat 5: phpro (40580 in chips)
Seat 6: oldyellowbricks (73184 in chips)
Seat 7: PhatAction09 (48880 in chips)
Seat 9: bayodelic2703 (13270 in chips)
stoner.fuzz6: posts the ante 175
Mokka90: posts the ante 175
FelipeCSilva: posts the ante 175
GroggRoger: posts the ante 175
phpro: posts the ante 175
oldyellowbricks: posts the ante 175
PhatAction09: posts the ante 175
bayodelic2703: posts the ante 175
stoner.fuzz6: posts small blind 700
Mokka90: posts big blind 1400
*** HOLE CARDS ***
Dealt to phpro [5s Th]
FelipeCSilva: folds
GroggRoger: folds
phpro: folds
oldyellowbricks: folds
PhatAction09: raises 47305 to 48705 and is all-in
bayodelic2703: folds
stoner.fuzz6: folds
Mokka90: calls 18984 and is all-in
Uncalled bet (28321) returned to PhatAction09
*** FLOP *** [Jh 7s 3c]
*** TURN *** [Jh 7s 3c] [Ah]
*** RIVER *** [Jh 7s 3c Ah] [8h]
*** SHOW DOWN ***
Mokka90: shows [4s 4h] (a pair of Fours)
PhatAction09: shows [Kc Js] (a pair of Jacks)
PhatAction09 collected 42868 from pot
Mokka90 finished the tournament in 23rd place and received $2.80.
*** SUMMARY ***
Total pot 42868 | Rake 0
Board [Jh 7s 3c Ah 8h]
Seat 1: stoner.fuzz6 (small blind) folded before Flop
Seat 2: Mokka90 (big blind) showed [4s 4h] and lost with a pair of Fours
Seat 3: FelipeCSilva folded before Flop (didn't bet)
Seat 4: GroggRoger folded before Flop (didn't bet)
Seat 5: phpro folded before Flop (didn't bet)
Seat 6: oldyellowbricks folded before Flop (didn't bet)
Seat 7: PhatAction09 showed [Kc Js] and won (42868) with a pair of Jacks
Seat 9: bayodelic2703 (button) folded before Flop (didn't bet)


*********** # 161 **************
PokerStars Hand #257047338777: Tournament #3910307458, $0.98+$0.12 USD Hold'em No Limit - Level XIX (700/1400) - 2025/07/22 12:43:02 ET
Table '3910307458 5' 9-max Seat #1 is the button
Seat 1: stoner.fuzz6 (6325 in chips)
Seat 3: FelipeCSilva (46088 in chips)
Seat 4: GroggRoger (30743 in chips)
Seat 5: phpro (40405 in chips)
Seat 6: oldyellowbricks (73009 in chips)
Seat 7: PhatAction09 (71189 in chips)
Seat 9: bayodelic2703 (13095 in chips)
stoner.fuzz6: posts the ante 175
FelipeCSilva: posts the ante 175
GroggRoger: posts the ante 175
phpro: posts the ante 175
oldyellowbricks: posts the ante 175
PhatAction09: posts the ante 175
bayodelic2703: posts the ante 175
FelipeCSilva: posts small blind 700
GroggRoger: posts big blind 1400
*** HOLE CARDS ***
Dealt to phpro [5h Ad]
phpro: folds
oldyellowbricks: folds
PhatAction09: raises 1750 to 3150
bayodelic2703: raises 9770 to 12920 and is all-in
stoner.fuzz6: folds
FelipeCSilva: folds
GroggRoger: folds
PhatAction09: calls 9770
oldyellowbricks is disconnected
*** FLOP *** [Tc 8d Td]
*** TURN *** [Tc 8d Td] [9c]
*** RIVER *** [Tc 8d Td 9c] [6h]
*** SHOW DOWN ***
PhatAction09: shows [As 8c] (two pair, Tens and Eights)
bayodelic2703: shows [Ks Qc] (a pair of Tens)
PhatAction09 collected 29165 from pot
bayodelic2703 finished the tournament in 22nd place and received $2.80.
*** SUMMARY ***
Total pot 29165 | Rake 0
Board [Tc 8d Td 9c 6h]
Seat 1: stoner.fuzz6 (button) folded before Flop (didn't bet)
Seat 3: FelipeCSilva (small blind) folded before Flop
Seat 4: GroggRoger (big blind) folded before Flop
Seat 5: phpro folded before Flop (didn't bet)
Seat 6: oldyellowbricks folded before Flop (didn't bet)
Seat 7: PhatAction09 showed [As 8c] and won (29165) with two pair, Tens and Eights
Seat 9: bayodelic2703 showed [Ks Qc] and lost with a pair of Tens


*********** # 162 **************
PokerStars Hand #257047348108: Tournament #3910307458, $0.98+$0.12 USD Hold'em No Limit - Level XIX (700/1400) - 2025/07/22 12:43:53 ET
Table '3910307458 5' 9-max Seat #3 is the button
Seat 1: stoner.fuzz6 (6150 in chips)
Seat 3: FelipeCSilva (45213 in chips)
Seat 4: GroggRoger (29168 in chips)
Seat 5: phpro (40230 in chips)
Seat 6: oldyellowbricks (72834 in chips)
Seat 7: PhatAction09 (87259 in chips)
stoner.fuzz6: posts the ante 175
FelipeCSilva: posts the ante 175
GroggRoger: posts the ante 175
phpro: posts the ante 175
oldyellowbricks: posts the ante 175
PhatAction09: posts the ante 175
GroggRoger: posts small blind 700
phpro: posts big blind 1400
*** HOLE CARDS ***
Dealt to phpro [7d Qs]
oldyellowbricks is disconnected
oldyellowbricks is connected
bullen1414 is disconnected
oldyellowbricks: folds
PhatAction09: folds
stoner.fuzz6: raises 4575 to 5975 and is all-in
FelipeCSilva: calls 5975
GroggRoger: folds
phpro: folds
*** FLOP *** [Kc 7s 7c]
*** TURN *** [Kc 7s 7c] [3d]
*** RIVER *** [Kc 7s 7c 3d] [8s]
*** SHOW DOWN ***
stoner.fuzz6: shows [2d As] (a pair of Sevens)
FelipeCSilva: shows [Ad Js] (a pair of Sevens - Ace+King+Jack kicker)
FelipeCSilva collected 15100 from pot
stoner.fuzz6 finished the tournament in 21st place and received $2.80.
*** SUMMARY ***
Total pot 15100 | Rake 0
Board [Kc 7s 7c 3d 8s]
Seat 1: stoner.fuzz6 showed [2d As] and lost with a pair of Sevens
Seat 3: FelipeCSilva (button) showed [Ad Js] and won (15100) with a pair of Sevens
Seat 4: GroggRoger (small blind) folded before Flop
Seat 5: phpro (big blind) folded before Flop
Seat 6: oldyellowbricks folded before Flop (didn't bet)
Seat 7: PhatAction09 folded before Flop (didn't bet)


*********** # 163 **************
PokerStars Hand #257047355476: Tournament #3910307458, $0.98+$0.12 USD Hold'em No Limit - Level XX (800/1600) - 2025/07/22 12:44:34 ET
Table '3910307458 5' 9-max Seat #4 is the button
Seat 3: FelipeCSilva (54163 in chips)
Seat 4: GroggRoger (28293 in chips)
Seat 5: phpro (38655 in chips)
Seat 6: oldyellowbricks (72659 in chips)
Seat 7: PhatAction09 (87084 in chips)
Seat 8: bullen1414 (42133 in chips)
FelipeCSilva: posts the ante 200
GroggRoger: posts the ante 200
phpro: posts the ante 200
oldyellowbricks: posts the ante 200
PhatAction09: posts the ante 200
bullen1414: posts the ante 200
phpro: posts small blind 800
oldyellowbricks: posts big blind 1600
*** HOLE CARDS ***
Dealt to phpro [6d 7c]
PhatAction09: folds
bullen1414: folds
FelipeCSilva: raises 1600 to 3200
GroggRoger: folds
phpro: folds
oldyellowbricks: folds
Uncalled bet (1600) returned to FelipeCSilva
FelipeCSilva collected 5200 from pot
FelipeCSilva: doesn't show hand
*** SUMMARY ***
Total pot 5200 | Rake 0
Seat 3: FelipeCSilva collected (5200)
Seat 4: GroggRoger (button) folded before Flop (didn't bet)
Seat 5: phpro (small blind) folded before Flop
Seat 6: oldyellowbricks (big blind) folded before Flop
Seat 7: PhatAction09 folded before Flop (didn't bet)
Seat 8: bullen1414 folded before Flop (didn't bet)


*********** # 164 **************
PokerStars Hand #257047358696: Tournament #3910307458, $0.98+$0.12 USD Hold'em No Limit - Level XX (800/1600) - 2025/07/22 12:44:51 ET
Table '3910307458 5' 9-max Seat #5 is the button
Seat 3: FelipeCSilva (57563 in chips)
Seat 4: GroggRoger (28093 in chips)
Seat 5: phpro (37655 in chips)
Seat 6: oldyellowbricks (70859 in chips)
Seat 7: PhatAction09 (86884 in chips)
Seat 8: bullen1414 (41933 in chips)
FelipeCSilva: posts the ante 200
GroggRoger: posts the ante 200
phpro: posts the ante 200
oldyellowbricks: posts the ante 200
PhatAction09: posts the ante 200
bullen1414: posts the ante 200
oldyellowbricks: posts small blind 800
PhatAction09: posts big blind 1600
*** HOLE CARDS ***
Dealt to phpro [4c 5h]
bullen1414: folds
FelipeCSilva: folds
GroggRoger: raises 3200 to 4800
phpro: folds
oldyellowbricks: folds
PhatAction09: folds
Uncalled bet (3200) returned to GroggRoger
GroggRoger collected 5200 from pot
GroggRoger: doesn't show hand
*** SUMMARY ***
Total pot 5200 | Rake 0
Seat 3: FelipeCSilva folded before Flop (didn't bet)
Seat 4: GroggRoger collected (5200)
Seat 5: phpro (button) folded before Flop (didn't bet)
Seat 6: oldyellowbricks (small blind) folded before Flop
Seat 7: PhatAction09 (big blind) folded before Flop
Seat 8: bullen1414 folded before Flop (didn't bet)


*********** # 165 **************
PokerStars Hand #257047367104: Tournament #3910307458, $0.98+$0.12 USD Hold'em No Limit - Level XX (800/1600) - 2025/07/22 12:45:38 ET
Table '3910307458 5' 9-max Seat #6 is the button
Seat 3: FelipeCSilva (57363 in chips)
Seat 4: GroggRoger (31493 in chips)
Seat 5: phpro (37455 in chips)
Seat 6: oldyellowbricks (69859 in chips)
Seat 7: PhatAction09 (85084 in chips)
Seat 8: bullen1414 (41733 in chips)
FelipeCSilva: posts the ante 200
GroggRoger: posts the ante 200
phpro: posts the ante 200
oldyellowbricks: posts the ante 200
PhatAction09: posts the ante 200
bullen1414: posts the ante 200
PhatAction09: posts small blind 800
bullen1414: posts big blind 1600
*** HOLE CARDS ***
Dealt to phpro [2s Th]
FelipeCSilva: folds
GroggRoger: folds
phpro: folds
oldyellowbricks: raises 1600 to 3200
PhatAction09: folds
bullen1414: folds
Uncalled bet (1600) returned to oldyellowbricks
oldyellowbricks collected 5200 from pot
oldyellowbricks: doesn't show hand
*** SUMMARY ***
Total pot 5200 | Rake 0
Seat 3: FelipeCSilva folded before Flop (didn't bet)
Seat 4: GroggRoger folded before Flop (didn't bet)
Seat 5: phpro folded before Flop (didn't bet)
Seat 6: oldyellowbricks (button) collected (5200)
Seat 7: PhatAction09 (small blind) folded before Flop
Seat 8: bullen1414 (big blind) folded before Flop


*********** # 166 **************
PokerStars Hand #257047370126: Tournament #3910307458, $0.98+$0.12 USD Hold'em No Limit - Level XX (800/1600) - 2025/07/22 12:45:54 ET
Table '3910307458 5' 9-max Seat #7 is the button
Seat 3: FelipeCSilva (57163 in chips)
Seat 4: GroggRoger (31293 in chips)
Seat 5: phpro (37255 in chips)
Seat 6: oldyellowbricks (73259 in chips)
Seat 7: PhatAction09 (84084 in chips)
Seat 8: bullen1414 (39933 in chips)
FelipeCSilva: posts the ante 200
GroggRoger: posts the ante 200
phpro: posts the ante 200
oldyellowbricks: posts the ante 200
PhatAction09: posts the ante 200
bullen1414: posts the ante 200
bullen1414: posts small blind 800
FelipeCSilva: posts big blind 1600
*** HOLE CARDS ***
Dealt to phpro [8s 8c]
GroggRoger: folds
phpro: raises 1600 to 3200
oldyellowbricks: folds
PhatAction09: folds
bullen1414: calls 2400
FelipeCSilva: folds
*** FLOP *** [Qh Kd 8h]
bullen1414: checks
phpro: bets 3036
bullen1414: folds
Uncalled bet (3036) returned to phpro
phpro collected 9200 from pot
phpro: doesn't show hand
*** SUMMARY ***
Total pot 9200 | Rake 0
Board [Qh Kd 8h]
Seat 3: FelipeCSilva (big blind) folded before Flop
Seat 4: GroggRoger folded before Flop (didn't bet)
Seat 5: phpro collected (9200)
Seat 6: oldyellowbricks folded before Flop (didn't bet)
Seat 7: PhatAction09 (button) folded before Flop (didn't bet)
Seat 8: bullen1414 (small blind) folded on the Flop


*********** # 167 **************
PokerStars Hand #257047376271: Tournament #3910307458, $0.98+$0.12 USD Hold'em No Limit - Level XX (800/1600) - 2025/07/22 12:46:28 ET
Table '3910307458 5' 9-max Seat #8 is the button
Seat 3: FelipeCSilva (55363 in chips)
Seat 4: GroggRoger (31093 in chips)
Seat 5: phpro (43055 in chips)
Seat 6: oldyellowbricks (73059 in chips)
Seat 7: PhatAction09 (83884 in chips)
Seat 8: bullen1414 (36533 in chips)
FelipeCSilva: posts the ante 200
GroggRoger: posts the ante 200
phpro: posts the ante 200
oldyellowbricks: posts the ante 200
PhatAction09: posts the ante 200
bullen1414: posts the ante 200
FelipeCSilva: posts small blind 800
GroggRoger: posts big blind 1600
*** HOLE CARDS ***
Dealt to phpro [9s 3s]
phpro: folds
oldyellowbricks: folds
PhatAction09: folds
bullen1414: raises 1760 to 3360
FelipeCSilva: folds
GroggRoger: folds
Uncalled bet (1760) returned to bullen1414
bullen1414 collected 5200 from pot
bullen1414: doesn't show hand
*** SUMMARY ***
Total pot 5200 | Rake 0
Seat 3: FelipeCSilva (small blind) folded before Flop
Seat 4: GroggRoger (big blind) folded before Flop
Seat 5: phpro folded before Flop (didn't bet)
Seat 6: oldyellowbricks folded before Flop (didn't bet)
Seat 7: PhatAction09 folded before Flop (didn't bet)
Seat 8: bullen1414 (button) collected (5200)


*********** # 168 **************
PokerStars Hand #257047378774: Tournament #3910307458, $0.98+$0.12 USD Hold'em No Limit - Level XX (800/1600) - 2025/07/22 12:46:42 ET
Table '3910307458 5' 9-max Seat #3 is the button
Seat 3: FelipeCSilva (54363 in chips)
Seat 4: GroggRoger (29293 in chips)
Seat 5: phpro (42855 in chips)
Seat 6: oldyellowbricks (72859 in chips)
Seat 7: PhatAction09 (83684 in chips)
Seat 8: bullen1414 (39933 in chips)
FelipeCSilva: posts the ante 200
GroggRoger: posts the ante 200
phpro: posts the ante 200
oldyellowbricks: posts the ante 200
PhatAction09: posts the ante 200
bullen1414: posts the ante 200
GroggRoger: posts small blind 800
phpro: posts big blind 1600
*** HOLE CARDS ***
Dealt to phpro [3h 5s]
oldyellowbricks: folds
PhatAction09: folds
bullen1414: folds
FelipeCSilva: folds
GroggRoger: raises 3200 to 4800
phpro: folds
Uncalled bet (3200) returned to GroggRoger
GroggRoger collected 4400 from pot
GroggRoger: doesn't show hand
*** SUMMARY ***
Total pot 4400 | Rake 0
Seat 3: FelipeCSilva (button) folded before Flop (didn't bet)
Seat 4: GroggRoger (small blind) collected (4400)
Seat 5: phpro (big blind) folded before Flop
Seat 6: oldyellowbricks folded before Flop (didn't bet)
Seat 7: PhatAction09 folded before Flop (didn't bet)
Seat 8: bullen1414 folded before Flop (didn't bet)


*********** # 169 **************
PokerStars Hand #257047384156: Tournament #3910307458, $0.98+$0.12 USD Hold'em No Limit - Level XX (800/1600) - 2025/07/22 12:47:12 ET
Table '3910307458 5' 9-max Seat #4 is the button
Seat 3: FelipeCSilva (54163 in chips)
Seat 4: GroggRoger (31893 in chips)
Seat 5: phpro (41055 in chips)
Seat 6: oldyellowbricks (72659 in chips)
Seat 7: PhatAction09 (83484 in chips)
Seat 8: bullen1414 (39733 in chips)
FelipeCSilva: posts the ante 200
GroggRoger: posts the ante 200
phpro: posts the ante 200
oldyellowbricks: posts the ante 200
PhatAction09: posts the ante 200
bullen1414: posts the ante 200
phpro: posts small blind 800
oldyellowbricks: posts big blind 1600
*** HOLE CARDS ***
Dealt to phpro [Qh 3d]
PhatAction09: folds
bullen1414: raises 1760 to 3360
FelipeCSilva: folds
GroggRoger: folds
phpro: folds
oldyellowbricks: raises 7840 to 11200
bullen1414: folds
Uncalled bet (7840) returned to oldyellowbricks
oldyellowbricks collected 8720 from pot
oldyellowbricks: doesn't show hand
*** SUMMARY ***
Total pot 8720 | Rake 0
Seat 3: FelipeCSilva folded before Flop (didn't bet)
Seat 4: GroggRoger (button) folded before Flop (didn't bet)
Seat 5: phpro (small blind) folded before Flop
Seat 6: oldyellowbricks (big blind) collected (8720)
Seat 7: PhatAction09 folded before Flop (didn't bet)
Seat 8: bullen1414 folded before Flop


*********** # 170 **************
PokerStars Hand #257047388733: Tournament #3910307458, $0.98+$0.12 USD Hold'em No Limit - Level XX (800/1600) - 2025/07/22 12:47:36 ET
Table '3910307458 5' 9-max Seat #5 is the button
Seat 3: FelipeCSilva (53963 in chips)
Seat 4: GroggRoger (31693 in chips)
Seat 5: phpro (40055 in chips)
Seat 6: oldyellowbricks (77819 in chips)
Seat 7: PhatAction09 (83284 in chips)
Seat 8: bullen1414 (36173 in chips)
FelipeCSilva: posts the ante 200
GroggRoger: posts the ante 200
phpro: posts the ante 200
oldyellowbricks: posts the ante 200
PhatAction09: posts the ante 200
bullen1414: posts the ante 200
oldyellowbricks: posts small blind 800
PhatAction09: posts big blind 1600
*** HOLE CARDS ***
Dealt to phpro [Kc Js]
bullen1414: folds
FelipeCSilva: folds
GroggRoger: folds
phpro: raises 1600 to 3200
oldyellowbricks: folds
PhatAction09: folds
Uncalled bet (1600) returned to phpro
phpro collected 5200 from pot
phpro: doesn't show hand
*** SUMMARY ***
Total pot 5200 | Rake 0
Seat 3: FelipeCSilva folded before Flop (didn't bet)
Seat 4: GroggRoger folded before Flop (didn't bet)
Seat 5: phpro (button) collected (5200)
Seat 6: oldyellowbricks (small blind) folded before Flop
Seat 7: PhatAction09 (big blind) folded before Flop
Seat 8: bullen1414 folded before Flop (didn't bet)


*********** # 171 **************
PokerStars Hand #257047393737: Tournament #3910307458, $0.98+$0.12 USD Hold'em No Limit - Level XX (800/1600) - 2025/07/22 12:48:04 ET
Table '3910307458 5' 9-max Seat #6 is the button
Seat 3: FelipeCSilva (53763 in chips)
Seat 4: GroggRoger (31493 in chips)
Seat 5: phpro (43455 in chips)
Seat 6: oldyellowbricks (76819 in chips)
Seat 7: PhatAction09 (81484 in chips)
Seat 8: bullen1414 (35973 in chips)
FelipeCSilva: posts the ante 200
GroggRoger: posts the ante 200
phpro: posts the ante 200
oldyellowbricks: posts the ante 200
PhatAction09: posts the ante 200
bullen1414: posts the ante 200
PhatAction09: posts small blind 800
bullen1414: posts big blind 1600
*** HOLE CARDS ***
Dealt to phpro [Qc 5d]
FelipeCSilva: raises 1600 to 3200
GroggRoger: raises 1600 to 4800
phpro: folds
oldyellowbricks: folds
PhatAction09: calls 4000
bullen1414: calls 3200
FelipeCSilva: calls 1600
*** FLOP *** [Kc Jd Kh]
PhatAction09: checks
bullen1414: checks
FelipeCSilva: checks
GroggRoger: bets 26493 and is all-in
PhatAction09: folds
bullen1414: folds
FelipeCSilva: folds
Uncalled bet (26493) returned to GroggRoger
GroggRoger collected 20400 from pot
GroggRoger: doesn't show hand
*** SUMMARY ***
Total pot 20400 | Rake 0
Board [Kc Jd Kh]
Seat 3: FelipeCSilva folded on the Flop
Seat 4: GroggRoger collected (20400)
Seat 5: phpro folded before Flop (didn't bet)
Seat 6: oldyellowbricks (button) folded before Flop (didn't bet)
Seat 7: PhatAction09 (small blind) folded on the Flop
Seat 8: bullen1414 (big blind) folded on the Flop


*********** # 172 **************
PokerStars Hand #257047401310: Tournament #3910307458, $0.98+$0.12 USD Hold'em No Limit - Level XX (800/1600) - 2025/07/22 12:48:45 ET
Table '3910307458 5' 9-max Seat #7 is the button
Seat 3: FelipeCSilva (48763 in chips)
Seat 4: GroggRoger (46893 in chips)
Seat 5: phpro (43255 in chips)
Seat 6: oldyellowbricks (76619 in chips)
Seat 7: PhatAction09 (76484 in chips)
Seat 8: bullen1414 (30973 in chips)
FelipeCSilva: posts the ante 200
GroggRoger: posts the ante 200
phpro: posts the ante 200
oldyellowbricks: posts the ante 200
PhatAction09: posts the ante 200
bullen1414: posts the ante 200
bullen1414: posts small blind 800
FelipeCSilva: posts big blind 1600
*** HOLE CARDS ***
Dealt to phpro [7d 2s]
GroggRoger: folds
phpro: folds
oldyellowbricks: raises 1600 to 3200
PhatAction09: folds
bullen1414: raises 27573 to 30773 and is all-in
FelipeCSilva: raises 17790 to 48563 and is all-in
oldyellowbricks: folds
Uncalled bet (17790) returned to FelipeCSilva
*** FLOP *** [8c Tc 6d]
*** TURN *** [8c Tc 6d] [Kd]
*** RIVER *** [8c Tc 6d Kd] [3s]
*** SHOW DOWN ***
bullen1414: shows [Ks Kh] (three of a kind, Kings)
FelipeCSilva: shows [Ah Qh] (high card Ace)
bullen1414 collected 65946 from pot
*** SUMMARY ***
Total pot 65946 | Rake 0
Board [8c Tc 6d Kd 3s]
Seat 3: FelipeCSilva (big blind) showed [Ah Qh] and lost with high card Ace
Seat 4: GroggRoger folded before Flop (didn't bet)
Seat 5: phpro folded before Flop (didn't bet)
Seat 6: oldyellowbricks folded before Flop
Seat 7: PhatAction09 (button) folded before Flop (didn't bet)
Seat 8: bullen1414 (small blind) showed [Ks Kh] and won (65946) with three of a kind, Kings


*********** # 173 **************
PokerStars Hand #257047406838: Tournament #3910307458, $0.98+$0.12 USD Hold'em No Limit - Level XX (800/1600) - 2025/07/22 12:49:15 ET
Table '3910307458 5' 9-max Seat #8 is the button
Seat 3: FelipeCSilva (17790 in chips)
Seat 4: GroggRoger (46693 in chips)
Seat 5: phpro (43055 in chips)
Seat 6: oldyellowbricks (73219 in chips)
Seat 7: PhatAction09 (76284 in chips)
Seat 8: bullen1414 (65946 in chips)
FelipeCSilva: posts the ante 200
GroggRoger: posts the ante 200
phpro: posts the ante 200
oldyellowbricks: posts the ante 200
PhatAction09: posts the ante 200
bullen1414: posts the ante 200
FelipeCSilva: posts small blind 800
GroggRoger: posts big blind 1600
*** HOLE CARDS ***
Dealt to phpro [Js Qc]
phpro: folds
oldyellowbricks: folds
PhatAction09: raises 2000 to 3600
bullen1414: folds
FelipeCSilva: folds
GroggRoger: folds
Uncalled bet (2000) returned to PhatAction09
PhatAction09 collected 5200 from pot
PhatAction09: doesn't show hand
*** SUMMARY ***
Total pot 5200 | Rake 0
Seat 3: FelipeCSilva (small blind) folded before Flop
Seat 4: GroggRoger (big blind) folded before Flop
Seat 5: phpro folded before Flop (didn't bet)
Seat 6: oldyellowbricks folded before Flop (didn't bet)
Seat 7: PhatAction09 collected (5200)
Seat 8: bullen1414 (button) folded before Flop (didn't bet)


*********** # 174 **************
PokerStars Hand #257047411239: Tournament #3910307458, $0.98+$0.12 USD Hold'em No Limit - Level XX (800/1600) - 2025/07/22 12:49:39 ET
Table '3910307458 5' 9-max Seat #3 is the button
Seat 3: FelipeCSilva (16790 in chips)
Seat 4: GroggRoger (44893 in chips)
Seat 5: phpro (42855 in chips)
Seat 6: oldyellowbricks (73019 in chips)
Seat 7: PhatAction09 (79684 in chips)
Seat 8: bullen1414 (65746 in chips)
FelipeCSilva: posts the ante 200
GroggRoger: posts the ante 200
phpro: posts the ante 200
oldyellowbricks: posts the ante 200
PhatAction09: posts the ante 200
bullen1414: posts the ante 200
GroggRoger: posts small blind 800
phpro: posts big blind 1600
*** HOLE CARDS ***
Dealt to phpro [Th 6d]
oldyellowbricks: folds
PhatAction09: folds
bullen1414: raises 1760 to 3360
FelipeCSilva: folds
GroggRoger: raises 9520 to 12880
phpro: folds
bullen1414: raises 52666 to 65546 and is all-in
GroggRoger: calls 31813 and is all-in
Uncalled bet (20853) returned to bullen1414
*** FLOP *** [4h Jh 2d]
*** TURN *** [4h Jh 2d] [Js]
*** RIVER *** [4h Jh 2d Js] [Kc]
*** SHOW DOWN ***
GroggRoger: shows [As 5c] (a pair of Jacks)
bullen1414: shows [Td Tc] (two pair, Jacks and Tens)
bullen1414 collected 92186 from pot
GroggRoger finished the tournament in 20th place and received $2.80.
Yuruch is disconnected
*** SUMMARY ***
Total pot 92186 | Rake 0
Board [4h Jh 2d Js Kc]
Seat 3: FelipeCSilva (button) folded before Flop (didn't bet)
Seat 4: GroggRoger (small blind) showed [As 5c] and lost with a pair of Jacks
Seat 5: phpro (big blind) folded before Flop
Seat 6: oldyellowbricks folded before Flop (didn't bet)
Seat 7: PhatAction09 folded before Flop (didn't bet)
Seat 8: bullen1414 showed [Td Tc] and won (92186) with two pair, Jacks and Tens


*********** # 175 **************
PokerStars Hand #257047419381: Tournament #3910307458, $0.98+$0.12 USD Hold'em No Limit - Level XX (800/1600) - 2025/07/22 12:50:24 ET
Table '3910307458 5' 9-max Seat #5 is the button
Seat 3: FelipeCSilva (16590 in chips)
Seat 4: Yuruch (23084 in chips)
Seat 5: phpro (41055 in chips)
Seat 6: oldyellowbricks (72819 in chips)
Seat 7: PhatAction09 (79484 in chips)
Seat 8: bullen1414 (113039 in chips)
FelipeCSilva: posts the ante 200
Yuruch: posts the ante 200
phpro: posts the ante 200
oldyellowbricks: posts the ante 200
PhatAction09: posts the ante 200
bullen1414: posts the ante 200
oldyellowbricks: posts small blind 800
PhatAction09: posts big blind 1600
*** HOLE CARDS ***
Dealt to phpro [5s 9h]
bullen1414: folds
FelipeCSilva: folds
Yuruch: folds
phpro: folds
oldyellowbricks: calls 800
PhatAction09: checks
*** FLOP *** [8s Qc Qs]
oldyellowbricks: checks
PhatAction09: checks
*** TURN *** [8s Qc Qs] [Qh]
oldyellowbricks: checks
PhatAction09: checks
*** RIVER *** [8s Qc Qs Qh] [7s]
oldyellowbricks: bets 3200
PhatAction09: folds
Uncalled bet (3200) returned to oldyellowbricks
oldyellowbricks collected 4400 from pot
oldyellowbricks: doesn't show hand
*** SUMMARY ***
Total pot 4400 | Rake 0
Board [8s Qc Qs Qh 7s]
Seat 3: FelipeCSilva folded before Flop (didn't bet)
Seat 4: Yuruch folded before Flop (didn't bet)
Seat 5: phpro (button) folded before Flop (didn't bet)
Seat 6: oldyellowbricks (small blind) collected (4400)
Seat 7: PhatAction09 (big blind) folded on the River
Seat 8: bullen1414 folded before Flop (didn't bet)


*********** # 176 **************
PokerStars Hand #257047429544: Tournament #3910307458, $0.98+$0.12 USD Hold'em No Limit - Level XX (800/1600) - 2025/07/22 12:51:18 ET
Table '3910307458 5' 9-max Seat #6 is the button
Seat 3: FelipeCSilva (16390 in chips)
Seat 4: Yuruch (22884 in chips)
Seat 5: phpro (40855 in chips)
Seat 6: oldyellowbricks (75419 in chips)
Seat 7: PhatAction09 (77684 in chips)
Seat 8: bullen1414 (112839 in chips)
FelipeCSilva: posts the ante 200
Yuruch: posts the ante 200
phpro: posts the ante 200
oldyellowbricks: posts the ante 200
PhatAction09: posts the ante 200
bullen1414: posts the ante 200
PhatAction09: posts small blind 800
bullen1414: posts big blind 1600
*** HOLE CARDS ***
Dealt to phpro [6c Qh]
FelipeCSilva: folds
Yuruch: folds
phpro: folds
oldyellowbricks: folds
PhatAction09: raises 4400 to 6000
bullen1414: calls 4400
*** FLOP *** [Tc 7s 3c]
PhatAction09: checks
bullen1414: checks
*** TURN *** [Tc 7s 3c] [Jd]
PhatAction09: checks
bullen1414: checks
*** RIVER *** [Tc 7s 3c Jd] [5h]
PhatAction09: checks
bullen1414: checks
*** SHOW DOWN ***
PhatAction09: shows [Kh 9c] (high card King)
bullen1414: shows [Ah 9s] (high card Ace)
bullen1414 collected 13200 from pot
*** SUMMARY ***
Total pot 13200 | Rake 0
Board [Tc 7s 3c Jd 5h]
Seat 3: FelipeCSilva folded before Flop (didn't bet)
Seat 4: Yuruch folded before Flop (didn't bet)
Seat 5: phpro folded before Flop (didn't bet)
Seat 6: oldyellowbricks (button) folded before Flop (didn't bet)
Seat 7: PhatAction09 (small blind) showed [Kh 9c] and lost with high card King
Seat 8: bullen1414 (big blind) showed [Ah 9s] and won (13200) with high card Ace


*********** # 177 **************
PokerStars Hand #257047440146: Tournament #3910307458, $0.98+$0.12 USD Hold'em No Limit - Level XX (800/1600) - 2025/07/22 12:52:15 ET
Table '3910307458 5' 9-max Seat #7 is the button
Seat 3: FelipeCSilva (16190 in chips)
Seat 4: Yuruch (22684 in chips)
Seat 5: phpro (40655 in chips)
Seat 6: oldyellowbricks (75219 in chips)
Seat 7: PhatAction09 (71484 in chips)
Seat 8: bullen1414 (119839 in chips)
FelipeCSilva: posts the ante 200
Yuruch: posts the ante 200
phpro: posts the ante 200
oldyellowbricks: posts the ante 200
PhatAction09: posts the ante 200
bullen1414: posts the ante 200
bullen1414: posts small blind 800
FelipeCSilva: posts big blind 1600
*** HOLE CARDS ***
Dealt to phpro [8h 9s]
Yuruch: raises 1600 to 3200
phpro: folds
oldyellowbricks: folds
PhatAction09: folds
bullen1414: folds
FelipeCSilva: calls 1600
*** FLOP *** [2h Ks 4c]
FelipeCSilva: checks
Yuruch: bets 19284 and is all-in
FelipeCSilva: folds
Uncalled bet (19284) returned to Yuruch
Yuruch collected 8400 from pot
Yuruch: doesn't show hand
*** SUMMARY ***
Total pot 8400 | Rake 0
Board [2h Ks 4c]
Seat 3: FelipeCSilva (big blind) folded on the Flop
Seat 4: Yuruch collected (8400)
Seat 5: phpro folded before Flop (didn't bet)
Seat 6: oldyellowbricks folded before Flop (didn't bet)
Seat 7: PhatAction09 (button) folded before Flop (didn't bet)
Seat 8: bullen1414 (small blind) folded before Flop


*********** # 178 **************
PokerStars Hand #257047446816: Tournament #3910307458, $0.98+$0.12 USD Hold'em No Limit - Level XX (800/1600) - 2025/07/22 12:52:50 ET
Table '3910307458 5' 9-max Seat #8 is the button
Seat 3: FelipeCSilva (12790 in chips)
Seat 4: Yuruch (27684 in chips)
Seat 5: phpro (40455 in chips)
Seat 6: oldyellowbricks (75019 in chips)
Seat 7: PhatAction09 (71284 in chips)
Seat 8: bullen1414 (118839 in chips)
FelipeCSilva: posts the ante 200
Yuruch: posts the ante 200
phpro: posts the ante 200
oldyellowbricks: posts the ante 200
PhatAction09: posts the ante 200
bullen1414: posts the ante 200
FelipeCSilva: posts small blind 800
Yuruch: posts big blind 1600
*** HOLE CARDS ***
Dealt to phpro [8d Jd]
phpro: folds
oldyellowbricks: folds
PhatAction09: folds
bullen1414: folds
FelipeCSilva: raises 10990 to 12590 and is all-in
Yuruch: folds
Uncalled bet (10990) returned to FelipeCSilva
FelipeCSilva collected 4400 from pot
FelipeCSilva: doesn't show hand
*** SUMMARY ***
Total pot 4400 | Rake 0
Seat 3: FelipeCSilva (small blind) collected (4400)
Seat 4: Yuruch (big blind) folded before Flop
Seat 5: phpro folded before Flop (didn't bet)
Seat 6: oldyellowbricks folded before Flop (didn't bet)
Seat 7: PhatAction09 folded before Flop (didn't bet)
Seat 8: bullen1414 (button) folded before Flop (didn't bet)


*********** # 179 **************
PokerStars Hand #257047449894: Tournament #3910307458, $0.98+$0.12 USD Hold'em No Limit - Level XX (800/1600) - 2025/07/22 12:53:07 ET
Table '3910307458 5' 9-max Seat #3 is the button
Seat 3: FelipeCSilva (15390 in chips)
Seat 4: Yuruch (25884 in chips)
Seat 5: phpro (40255 in chips)
Seat 6: oldyellowbricks (74819 in chips)
Seat 7: PhatAction09 (71084 in chips)
Seat 8: bullen1414 (118639 in chips)
FelipeCSilva: posts the ante 200
Yuruch: posts the ante 200
phpro: posts the ante 200
oldyellowbricks: posts the ante 200
PhatAction09: posts the ante 200
bullen1414: posts the ante 200
Yuruch: posts small blind 800
phpro: posts big blind 1600
*** HOLE CARDS ***
Dealt to phpro [5d Js]
oldyellowbricks: raises 1600 to 3200
PhatAction09: folds
bullen1414: calls 3200
FelipeCSilva: folds
Yuruch: folds
phpro: folds
*** FLOP *** [Ad Ac 2d]
oldyellowbricks: checks
bullen1414: checks
*** TURN *** [Ad Ac 2d] [7h]
oldyellowbricks: bets 3200
bullen1414: folds
Uncalled bet (3200) returned to oldyellowbricks
oldyellowbricks collected 10000 from pot
oldyellowbricks: doesn't show hand
*** SUMMARY ***
Total pot 10000 | Rake 0
Board [Ad Ac 2d 7h]
Seat 3: FelipeCSilva (button) folded before Flop (didn't bet)
Seat 4: Yuruch (small blind) folded before Flop
Seat 5: phpro (big blind) folded before Flop
Seat 6: oldyellowbricks collected (10000)
Seat 7: PhatAction09 folded before Flop (didn't bet)
Seat 8: bullen1414 folded on the Turn


*********** # 180 **************
PokerStars Hand #257047454619: Tournament #3910307458, $0.98+$0.12 USD Hold'em No Limit - Level XX (800/1600) - 2025/07/22 12:53:32 ET
Table '3910307458 5' 9-max Seat #4 is the button
Seat 3: FelipeCSilva (15190 in chips)
Seat 4: Yuruch (24884 in chips)
Seat 5: phpro (38455 in chips)
Seat 6: oldyellowbricks (81419 in chips)
Seat 7: PhatAction09 (70884 in chips)
Seat 8: bullen1414 (115239 in chips)
FelipeCSilva: posts the ante 200
Yuruch: posts the ante 200
phpro: posts the ante 200
oldyellowbricks: posts the ante 200
PhatAction09: posts the ante 200
bullen1414: posts the ante 200
phpro: posts small blind 800
oldyellowbricks: posts big blind 1600
*** HOLE CARDS ***
Dealt to phpro [2h 2d]
PhatAction09: folds
bullen1414: folds
FelipeCSilva: raises 13390 to 14990 and is all-in
Yuruch: folds
phpro: folds
oldyellowbricks: folds
Uncalled bet (13390) returned to FelipeCSilva
FelipeCSilva collected 5200 from pot
FelipeCSilva: doesn't show hand
*** SUMMARY ***
Total pot 5200 | Rake 0
Seat 3: FelipeCSilva collected (5200)
Seat 4: Yuruch (button) folded before Flop (didn't bet)
Seat 5: phpro (small blind) folded before Flop
Seat 6: oldyellowbricks (big blind) folded before Flop
Seat 7: PhatAction09 folded before Flop (didn't bet)
Seat 8: bullen1414 folded before Flop (didn't bet)


*********** # 181 **************
PokerStars Hand #257047458664: Tournament #3910307458, $0.98+$0.12 USD Hold'em No Limit - Level XX (800/1600) - 2025/07/22 12:53:54 ET
Table '3910307458 5' 9-max Seat #5 is the button
Seat 3: FelipeCSilva (18590 in chips)
Seat 4: Yuruch (24684 in chips)
Seat 5: phpro (37455 in chips)
Seat 6: oldyellowbricks (79619 in chips)
Seat 7: PhatAction09 (70684 in chips)
Seat 8: bullen1414 (115039 in chips)
FelipeCSilva: posts the ante 200
Yuruch: posts the ante 200
phpro: posts the ante 200
oldyellowbricks: posts the ante 200
PhatAction09: posts the ante 200
bullen1414: posts the ante 200
oldyellowbricks: posts small blind 800
PhatAction09: posts big blind 1600
*** HOLE CARDS ***
Dealt to phpro [9d Ah]
bullen1414: folds
FelipeCSilva: folds
Yuruch: folds
phpro: raises 1600 to 3200
oldyellowbricks: folds
PhatAction09: folds
Uncalled bet (1600) returned to phpro
phpro collected 5200 from pot
phpro: doesn't show hand
*** SUMMARY ***
Total pot 5200 | Rake 0
Seat 3: FelipeCSilva folded before Flop (didn't bet)
Seat 4: Yuruch folded before Flop (didn't bet)
Seat 5: phpro (button) collected (5200)
Seat 6: oldyellowbricks (small blind) folded before Flop
Seat 7: PhatAction09 (big blind) folded before Flop
Seat 8: bullen1414 folded before Flop (didn't bet)


*********** # 182 **************
PokerStars Hand #257047465920: Tournament #3910307458, $0.98+$0.12 USD Hold'em No Limit - Level XXI (900/1800) - 2025/07/22 12:54:32 ET
Table '3910307458 5' 9-max Seat #6 is the button
Seat 3: FelipeCSilva (18390 in chips)
Seat 4: Yuruch (24484 in chips)
Seat 5: phpro (40855 in chips)
Seat 6: oldyellowbricks (78619 in chips)
Seat 7: PhatAction09 (68884 in chips)
Seat 8: bullen1414 (114839 in chips)
FelipeCSilva: posts the ante 225
Yuruch: posts the ante 225
phpro: posts the ante 225
oldyellowbricks: posts the ante 225
PhatAction09: posts the ante 225
bullen1414: posts the ante 225
PhatAction09: posts small blind 900
bullen1414: posts big blind 1800
*** HOLE CARDS ***
Dealt to phpro [7d Jc]
FelipeCSilva: folds
Yuruch: folds
phpro: folds
oldyellowbricks: folds
PhatAction09: folds
Uncalled bet (900) returned to bullen1414
bullen1414 collected 3150 from pot
bullen1414: doesn't show hand
*** SUMMARY ***
Total pot 3150 | Rake 0
Seat 3: FelipeCSilva folded before Flop (didn't bet)
Seat 4: Yuruch folded before Flop (didn't bet)
Seat 5: phpro folded before Flop (didn't bet)
Seat 6: oldyellowbricks (button) folded before Flop (didn't bet)
Seat 7: PhatAction09 (small blind) folded before Flop
Seat 8: bullen1414 (big blind) collected (3150)


*********** # 183 **************
PokerStars Hand #257047468225: Tournament #3910307458, $0.98+$0.12 USD Hold'em No Limit - Level XXI (900/1800) - 2025/07/22 12:54:45 ET
Table '3910307458 5' 9-max Seat #7 is the button
Seat 3: FelipeCSilva (18165 in chips)
Seat 4: Yuruch (24259 in chips)
Seat 5: phpro (40630 in chips)
Seat 6: oldyellowbricks (78394 in chips)
Seat 7: PhatAction09 (67759 in chips)
Seat 8: bullen1414 (116864 in chips)
FelipeCSilva: posts the ante 225
Yuruch: posts the ante 225
phpro: posts the ante 225
oldyellowbricks: posts the ante 225
PhatAction09: posts the ante 225
bullen1414: posts the ante 225
bullen1414: posts small blind 900
FelipeCSilva: posts big blind 1800
*** HOLE CARDS ***
Dealt to phpro [4h 6h]
Yuruch: folds
phpro: folds
oldyellowbricks: raises 1800 to 3600
PhatAction09: folds
bullen1414: folds
FelipeCSilva: raises 14340 to 17940 and is all-in
oldyellowbricks: calls 14340
*** FLOP *** [4s 2c 2h]
*** TURN *** [4s 2c 2h] [Ah]
*** RIVER *** [4s 2c 2h Ah] [Kc]
*** SHOW DOWN ***
FelipeCSilva: shows [3c 3d] (two pair, Threes and Deuces)
oldyellowbricks: shows [Ad Ts] (two pair, Aces and Deuces)
oldyellowbricks collected 38130 from pot
FelipeCSilva finished the tournament in 19th place and received $2.80.
*** SUMMARY ***
Total pot 38130 | Rake 0
Board [4s 2c 2h Ah Kc]
Seat 3: FelipeCSilva (big blind) showed [3c 3d] and lost with two pair, Threes and Deuces
Seat 4: Yuruch folded before Flop (didn't bet)
Seat 5: phpro folded before Flop (didn't bet)
Seat 6: oldyellowbricks showed [Ad Ts] and won (38130) with two pair, Aces and Deuces
Seat 7: PhatAction09 (button) folded before Flop (didn't bet)
Seat 8: bullen1414 (small blind) folded before Flop


*********** # 184 **************
PokerStars Hand #257047515977: Tournament #3910307458, $0.98+$0.12 USD Hold'em No Limit - Level XXI (900/1800) - 2025/07/22 13:00:24 ET
Table '3910307458 19' 9-max Seat #2 is the button
Seat 1: odanilolm (11785 in chips)
Seat 2: gembrian1983 (36505 in chips)
Seat 3: thereaper2u (19461 in chips)
Seat 4: McLci (52813 in chips)
Seat 5: cpbf (17270 in chips)
Seat 6: oldyellowbricks (98359 in chips)
Seat 7: phpro (40405 in chips)
Seat 8: ValeraB96 (82905 in chips)
Seat 9: PhatAction09 (67534 in chips)
odanilolm: posts the ante 225
gembrian1983: posts the ante 225
thereaper2u: posts the ante 225
McLci: posts the ante 225
cpbf: posts the ante 225
oldyellowbricks: posts the ante 225
phpro: posts the ante 225
ValeraB96: posts the ante 225
PhatAction09: posts the ante 225
thereaper2u: posts small blind 900
McLci: posts big blind 1800
*** HOLE CARDS ***
Dealt to phpro [Jc 4d]
cpbf: folds
oldyellowbricks is disconnected
oldyellowbricks is connected
oldyellowbricks: raises 1800 to 3600
phpro: folds
ValeraB96: folds
PhatAction09: folds
odanilolm has timed out while disconnected
odanilolm: folds
odanilolm is sitting out
gembrian1983: folds
thereaper2u: folds
McLci: folds
Uncalled bet (1800) returned to oldyellowbricks
oldyellowbricks collected 6525 from pot
oldyellowbricks: doesn't show hand
*** SUMMARY ***
Total pot 6525 | Rake 0
Seat 1: odanilolm folded before Flop (didn't bet)
Seat 2: gembrian1983 (button) folded before Flop (didn't bet)
Seat 3: thereaper2u (small blind) folded before Flop
Seat 4: McLci (big blind) folded before Flop
Seat 5: cpbf folded before Flop (didn't bet)
Seat 6: oldyellowbricks collected (6525)
Seat 7: phpro folded before Flop (didn't bet)
Seat 8: ValeraB96 folded before Flop (didn't bet)
Seat 9: PhatAction09 folded before Flop (didn't bet)


*********** # 185 **************
PokerStars Hand #257047525617: Tournament #3910307458, $0.98+$0.12 USD Hold'em No Limit - Level XXI (900/1800) - 2025/07/22 13:01:24 ET
Table '3910307458 19' 9-max Seat #3 is the button
Seat 1: odanilolm (11560 in chips) is sitting out
Seat 2: gembrian1983 (36280 in chips)
Seat 3: thereaper2u (18336 in chips)
Seat 4: McLci (50788 in chips)
Seat 5: cpbf (17045 in chips)
Seat 6: oldyellowbricks (102859 in chips)
Seat 7: phpro (40180 in chips)
Seat 8: ValeraB96 (82680 in chips)
Seat 9: PhatAction09 (67309 in chips)
odanilolm: posts the ante 225
gembrian1983: posts the ante 225
thereaper2u: posts the ante 225
McLci: posts the ante 225
cpbf: posts the ante 225
oldyellowbricks: posts the ante 225
phpro: posts the ante 225
ValeraB96: posts the ante 225
PhatAction09: posts the ante 225
McLci: posts small blind 900
cpbf: posts big blind 1800
*** HOLE CARDS ***
Dealt to phpro [Kd Jc]
oldyellowbricks: folds
phpro: raises 1800 to 3600
ValeraB96: folds
PhatAction09: folds
odanilolm: folds
gembrian1983: folds
thereaper2u: folds
McLci: folds
cpbf: calls 1800
*** FLOP *** [Qc 3c Ts]
cpbf: checks
phpro: bets 3341
cpbf: folds
Uncalled bet (3341) returned to phpro
phpro collected 10125 from pot
phpro: doesn't show hand
*** SUMMARY ***
Total pot 10125 | Rake 0
Board [Qc 3c Ts]
Seat 1: odanilolm folded before Flop (didn't bet)
Seat 2: gembrian1983 folded before Flop (didn't bet)
Seat 3: thereaper2u (button) folded before Flop (didn't bet)
Seat 4: McLci (small blind) folded before Flop
Seat 5: cpbf (big blind) folded on the Flop
Seat 6: oldyellowbricks folded before Flop (didn't bet)
Seat 7: phpro collected (10125)
Seat 8: ValeraB96 folded before Flop (didn't bet)
Seat 9: PhatAction09 folded before Flop (didn't bet)


*********** # 186 **************
PokerStars Hand #257047531956: Tournament #3910307458, $0.98+$0.12 USD Hold'em No Limit - Level XXI (900/1800) - 2025/07/22 13:01:59 ET
Table '3910307458 19' 9-max Seat #4 is the button
Seat 1: odanilolm (11335 in chips) is sitting out
Seat 2: gembrian1983 (36055 in chips)
Seat 3: thereaper2u (18111 in chips)
Seat 4: McLci (49663 in chips)
Seat 5: cpbf (13220 in chips)
Seat 6: oldyellowbricks (102634 in chips)
Seat 7: phpro (46480 in chips)
Seat 8: ValeraB96 (82455 in chips)
Seat 9: PhatAction09 (67084 in chips)
odanilolm: posts the ante 225
gembrian1983: posts the ante 225
thereaper2u: posts the ante 225
McLci: posts the ante 225
cpbf: posts the ante 225
oldyellowbricks: posts the ante 225
phpro: posts the ante 225
ValeraB96: posts the ante 225
PhatAction09: posts the ante 225
cpbf: posts small blind 900
oldyellowbricks: posts big blind 1800
*** HOLE CARDS ***
Dealt to phpro [7h Jh]
phpro: folds
ValeraB96: folds
PhatAction09: folds
odanilolm: folds
gembrian1983 has timed out
gembrian1983: folds
gembrian1983 is sitting out
thereaper2u: raises 16086 to 17886 and is all-in
McLci: folds
cpbf: folds
oldyellowbricks: folds
Uncalled bet (16086) returned to thereaper2u
thereaper2u collected 6525 from pot
thereaper2u: doesn't show hand
*** SUMMARY ***
Total pot 6525 | Rake 0
Seat 1: odanilolm folded before Flop (didn't bet)
Seat 2: gembrian1983 folded before Flop (didn't bet)
Seat 3: thereaper2u collected (6525)
Seat 4: McLci (button) folded before Flop (didn't bet)
Seat 5: cpbf (small blind) folded before Flop
Seat 6: oldyellowbricks (big blind) folded before Flop
Seat 7: phpro folded before Flop (didn't bet)
Seat 8: ValeraB96 folded before Flop (didn't bet)
Seat 9: PhatAction09 folded before Flop (didn't bet)


*********** # 187 **************
PokerStars Hand #257047541967: Tournament #3910307458, $0.98+$0.12 USD Hold'em No Limit - Level XXI (900/1800) - 2025/07/22 13:02:54 ET
Table '3910307458 19' 9-max Seat #5 is the button
Seat 1: odanilolm (11110 in chips) is sitting out
Seat 2: gembrian1983 (35830 in chips) is sitting out
Seat 3: thereaper2u (22611 in chips)
Seat 4: McLci (49438 in chips)
Seat 5: cpbf (12095 in chips)
Seat 6: oldyellowbricks (100609 in chips)
Seat 7: phpro (46255 in chips)
Seat 8: ValeraB96 (82230 in chips)
Seat 9: PhatAction09 (66859 in chips)
odanilolm: posts the ante 225
gembrian1983: posts the ante 225
thereaper2u: posts the ante 225
McLci: posts the ante 225
cpbf: posts the ante 225
oldyellowbricks: posts the ante 225
phpro: posts the ante 225
ValeraB96: posts the ante 225
PhatAction09: posts the ante 225
oldyellowbricks: posts small blind 900
phpro: posts big blind 1800
*** HOLE CARDS ***
Dealt to phpro [4c Ts]
ValeraB96: folds
gembrian1983 is disconnected
PhatAction09: folds
odanilolm: folds
gembrian1983: folds
thereaper2u: folds
gembrian1983 is disconnected
McLci: folds
odanilolm is disconnected
odanilolm has returned
gembrian1983 has returned
cpbf: raises 10070 to 11870 and is all-in
oldyellowbricks: folds
phpro: folds
Uncalled bet (10070) returned to cpbf
cpbf collected 6525 from pot
cpbf: doesn't show hand
*** SUMMARY ***
Total pot 6525 | Rake 0
Seat 1: odanilolm folded before Flop (didn't bet)
Seat 2: gembrian1983 folded before Flop (didn't bet)
Seat 3: thereaper2u folded before Flop (didn't bet)
Seat 4: McLci folded before Flop (didn't bet)
Seat 5: cpbf (button) collected (6525)
Seat 6: oldyellowbricks (small blind) folded before Flop
Seat 7: phpro (big blind) folded before Flop
Seat 8: ValeraB96 folded before Flop (didn't bet)
Seat 9: PhatAction09 folded before Flop (didn't bet)


*********** # 188 **************
PokerStars Hand #257047547144: Tournament #3910307458, $0.98+$0.12 USD Hold'em No Limit - Level XXI (900/1800) - 2025/07/22 13:03:22 ET
Table '3910307458 19' 9-max Seat #6 is the button
Seat 1: odanilolm (10885 in chips)
Seat 2: gembrian1983 (35605 in chips)
Seat 3: thereaper2u (22386 in chips)
Seat 4: McLci (49213 in chips)
Seat 5: cpbf (16595 in chips)
Seat 6: oldyellowbricks (99484 in chips)
Seat 7: phpro (44230 in chips)
Seat 8: ValeraB96 (82005 in chips)
Seat 9: PhatAction09 (66634 in chips)
odanilolm: posts the ante 225
gembrian1983: posts the ante 225
thereaper2u: posts the ante 225
McLci: posts the ante 225
cpbf: posts the ante 225
oldyellowbricks: posts the ante 225
phpro: posts the ante 225
ValeraB96: posts the ante 225
PhatAction09: posts the ante 225
phpro: posts small blind 900
ValeraB96: posts big blind 1800
*** HOLE CARDS ***
Dealt to phpro [8d 6c]
PhatAction09: folds
odanilolm: folds
gembrian1983: raises 1800 to 3600
thereaper2u: raises 18561 to 22161 and is all-in
McLci: folds
cpbf: folds
oldyellowbricks: folds
phpro: folds
ValeraB96: folds
gembrian1983: calls 18561
*** FLOP *** [6h 7d 5d]
*** TURN *** [6h 7d 5d] [As]
*** RIVER *** [6h 7d 5d As] [Th]
*** SHOW DOWN ***
gembrian1983: shows [3d 3s] (a pair of Threes)
thereaper2u: shows [Ad Qd] (a pair of Aces)
thereaper2u collected 49047 from pot
*** SUMMARY ***
Total pot 49047 | Rake 0
Board [6h 7d 5d As Th]
Seat 1: odanilolm folded before Flop (didn't bet)
Seat 2: gembrian1983 showed [3d 3s] and lost with a pair of Threes
Seat 3: thereaper2u showed [Ad Qd] and won (49047) with a pair of Aces
Seat 4: McLci folded before Flop (didn't bet)
Seat 5: cpbf folded before Flop (didn't bet)
Seat 6: oldyellowbricks (button) folded before Flop (didn't bet)
Seat 7: phpro (small blind) folded before Flop
Seat 8: ValeraB96 (big blind) folded before Flop
Seat 9: PhatAction09 folded before Flop (didn't bet)


*********** # 189 **************
PokerStars Hand #257047552386: Tournament #3910307458, $0.98+$0.12 USD Hold'em No Limit - Level XXI (900/1800) - 2025/07/22 13:03:50 ET
Table '3910307458 19' 9-max Seat #7 is the button
Seat 1: odanilolm (10660 in chips)
Seat 2: gembrian1983 (13219 in chips)
Seat 3: thereaper2u (49047 in chips)
Seat 4: McLci (48988 in chips)
Seat 5: cpbf (16370 in chips)
Seat 6: oldyellowbricks (99259 in chips)
Seat 7: phpro (43105 in chips)
Seat 8: ValeraB96 (79980 in chips)
Seat 9: PhatAction09 (66409 in chips)
odanilolm: posts the ante 225
gembrian1983: posts the ante 225
thereaper2u: posts the ante 225
McLci: posts the ante 225
cpbf: posts the ante 225
oldyellowbricks: posts the ante 225
phpro: posts the ante 225
ValeraB96: posts the ante 225
PhatAction09: posts the ante 225
ValeraB96: posts small blind 900
PhatAction09: posts big blind 1800
*** HOLE CARDS ***
Dealt to phpro [4h As]
odanilolm: folds
gembrian1983: folds
thereaper2u: folds
McLci: folds
odanilolm is disconnected
cpbf: raises 14345 to 16145 and is all-in
oldyellowbricks: calls 16145
phpro: folds
ValeraB96: folds
PhatAction09: folds
*** FLOP *** [6h 2c 9d]
*** TURN *** [6h 2c 9d] [8d]
*** RIVER *** [6h 2c 9d 8d] [3s]
*** SHOW DOWN ***
cpbf: shows [Qc Kh] (high card King)
oldyellowbricks: shows [Qs Qh] (a pair of Queens)
oldyellowbricks collected 37015 from pot
cpbf finished the tournament in 18th place and received $2.80.
*** SUMMARY ***
Total pot 37015 | Rake 0
Board [6h 2c 9d 8d 3s]
Seat 1: odanilolm folded before Flop (didn't bet)
Seat 2: gembrian1983 folded before Flop (didn't bet)
Seat 3: thereaper2u folded before Flop (didn't bet)
Seat 4: McLci folded before Flop (didn't bet)
Seat 5: cpbf showed [Qc Kh] and lost with high card King
Seat 6: oldyellowbricks showed [Qs Qh] and won (37015) with a pair of Queens
Seat 7: phpro (button) folded before Flop (didn't bet)
Seat 8: ValeraB96 (small blind) folded before Flop
Seat 9: PhatAction09 (big blind) folded before Flop


*********** # 190 **************
PokerStars Hand #257047559595: Tournament #3910307458, $0.98+$0.12 USD Hold'em No Limit - Level XXI (900/1800) - 2025/07/22 13:04:29 ET
Table '3910307458 19' 9-max Seat #8 is the button
Seat 1: odanilolm (10435 in chips)
Seat 2: gembrian1983 (12994 in chips)
Seat 3: thereaper2u (48822 in chips)
Seat 4: McLci (48763 in chips)
Seat 6: oldyellowbricks (119904 in chips)
Seat 7: phpro (42880 in chips)
Seat 8: ValeraB96 (78855 in chips)
Seat 9: PhatAction09 (64384 in chips)
odanilolm: posts the ante 225
gembrian1983: posts the ante 225
thereaper2u: posts the ante 225
McLci: posts the ante 225
oldyellowbricks: posts the ante 225
phpro: posts the ante 225
ValeraB96: posts the ante 225
PhatAction09: posts the ante 225
PhatAction09: posts small blind 900
odanilolm: posts big blind 1800
*** HOLE CARDS ***
Dealt to phpro [Jd 5c]
gembrian1983 has timed out
gembrian1983: folds
gembrian1983 is sitting out
thereaper2u: folds
McLci: folds
odanilolm is disconnected
oldyellowbricks: raises 1800 to 3600
phpro: folds
ValeraB96: folds
gembrian1983 has returned
PhatAction09: folds
odanilolm: calls 1800
*** FLOP *** [Ts 9s 9d]
odanilolm: checks
oldyellowbricks: bets 7200
odanilolm: folds
Uncalled bet (7200) returned to oldyellowbricks
oldyellowbricks collected 9900 from pot
oldyellowbricks: doesn't show hand
*** SUMMARY ***
Total pot 9900 | Rake 0
Board [Ts 9s 9d]
Seat 1: odanilolm (big blind) folded on the Flop
Seat 2: gembrian1983 folded before Flop (didn't bet)
Seat 3: thereaper2u folded before Flop (didn't bet)
Seat 4: McLci folded before Flop (didn't bet)
Seat 6: oldyellowbricks collected (9900)
Seat 7: phpro folded before Flop (didn't bet)
Seat 8: ValeraB96 (button) folded before Flop (didn't bet)
Seat 9: PhatAction09 (small blind) folded before Flop


*********** # 191 **************
PokerStars Hand #257047571740: Tournament #3910307458, $0.98+$0.12 USD Hold'em No Limit - Level XXI (900/1800) - 2025/07/22 13:05:33 ET
Table '3910307458 19' 9-max Seat #9 is the button
Seat 1: odanilolm (6610 in chips)
Seat 2: gembrian1983 (12769 in chips)
Seat 3: thereaper2u (48597 in chips)
Seat 4: McLci (48538 in chips)
Seat 6: oldyellowbricks (125979 in chips)
Seat 7: phpro (42655 in chips)
Seat 8: ValeraB96 (78630 in chips)
Seat 9: PhatAction09 (63259 in chips)
odanilolm: posts the ante 225
gembrian1983: posts the ante 225
thereaper2u: posts the ante 225
McLci: posts the ante 225
oldyellowbricks: posts the ante 225
phpro: posts the ante 225
ValeraB96: posts the ante 225
PhatAction09: posts the ante 225
odanilolm: posts small blind 900
gembrian1983: posts big blind 1800
*** HOLE CARDS ***
Dealt to phpro [8s 2h]
thereaper2u: raises 6300 to 8100
McLci: folds
oldyellowbricks: folds
phpro: folds
ValeraB96: folds
PhatAction09: folds
odanilolm: calls 5485 and is all-in
gembrian1983: folds
Uncalled bet (1715) returned to thereaper2u
*** FLOP *** [4s Ts Ac]
*** TURN *** [4s Ts Ac] [5s]
*** RIVER *** [4s Ts Ac 5s] [5c]
*** SHOW DOWN ***
odanilolm: shows [Qs Ks] (a flush, King high)
thereaper2u: shows [Qc Ad] (two pair, Aces and Fives)
odanilolm collected 16370 from pot
*** SUMMARY ***
Total pot 16370 | Rake 0
Board [4s Ts Ac 5s 5c]
Seat 1: odanilolm (small blind) showed [Qs Ks] and won (16370) with a flush, King high
Seat 2: gembrian1983 (big blind) folded before Flop
Seat 3: thereaper2u showed [Qc Ad] and lost with two pair, Aces and Fives
Seat 4: McLci folded before Flop (didn't bet)
Seat 6: oldyellowbricks folded before Flop (didn't bet)
Seat 7: phpro folded before Flop (didn't bet)
Seat 8: ValeraB96 folded before Flop (didn't bet)
Seat 9: PhatAction09 (button) folded before Flop (didn't bet)


*********** # 192 **************
PokerStars Hand #257047577894: Tournament #3910307458, $0.98+$0.12 USD Hold'em No Limit - Level XXI (900/1800) - 2025/07/22 13:06:06 ET
Table '3910307458 19' 9-max Seat #1 is the button
Seat 1: odanilolm (16370 in chips)
Seat 2: gembrian1983 (10744 in chips)
Seat 3: thereaper2u (41987 in chips)
Seat 4: McLci (48313 in chips)
Seat 6: oldyellowbricks (125754 in chips)
Seat 7: phpro (42430 in chips)
Seat 8: ValeraB96 (78405 in chips)
Seat 9: PhatAction09 (63034 in chips)
odanilolm: posts the ante 225
gembrian1983: posts the ante 225
thereaper2u: posts the ante 225
McLci: posts the ante 225
oldyellowbricks: posts the ante 225
phpro: posts the ante 225
ValeraB96: posts the ante 225
PhatAction09: posts the ante 225
gembrian1983: posts small blind 900
thereaper2u: posts big blind 1800
*** HOLE CARDS ***
Dealt to phpro [Qh As]
McLci: folds
oldyellowbricks: raises 1800 to 3600
phpro: calls 3600
ValeraB96: folds
PhatAction09: folds
odanilolm: folds
gembrian1983: folds
thereaper2u: folds
*** FLOP *** [5h 4s 3h]
oldyellowbricks: checks
phpro: checks
*** TURN *** [5h 4s 3h] [2c]
oldyellowbricks: checks
phpro: bets 3861
oldyellowbricks: folds
Uncalled bet (3861) returned to phpro
phpro collected 11700 from pot
*** SUMMARY ***
Total pot 11700 | Rake 0
Board [5h 4s 3h 2c]
Seat 1: odanilolm (button) folded before Flop (didn't bet)
Seat 2: gembrian1983 (small blind) folded before Flop
Seat 3: thereaper2u (big blind) folded before Flop
Seat 4: McLci folded before Flop (didn't bet)
Seat 6: oldyellowbricks folded on the Turn
Seat 7: phpro collected (11700)
Seat 8: ValeraB96 folded before Flop (didn't bet)
Seat 9: PhatAction09 folded before Flop (didn't bet)


*********** # 193 **************
PokerStars Hand #257047589629: Tournament #3910307458, $0.98+$0.12 USD Hold'em No Limit - Level XXI (900/1800) - 2025/07/22 13:07:09 ET
Table '3910307458 19' 9-max Seat #2 is the button
Seat 1: odanilolm (16145 in chips)
Seat 2: gembrian1983 (9619 in chips)
Seat 3: thereaper2u (39962 in chips)
Seat 4: McLci (48088 in chips)
Seat 6: oldyellowbricks (121929 in chips)
Seat 7: phpro (50305 in chips)
Seat 8: ValeraB96 (78180 in chips)
Seat 9: PhatAction09 (62809 in chips)
odanilolm: posts the ante 225
gembrian1983: posts the ante 225
thereaper2u: posts the ante 225
McLci: posts the ante 225
oldyellowbricks: posts the ante 225
phpro: posts the ante 225
ValeraB96: posts the ante 225
PhatAction09: posts the ante 225
thereaper2u: posts small blind 900
McLci: posts big blind 1800
*** HOLE CARDS ***
Dealt to phpro [Ac 2s]
oldyellowbricks: folds
phpro: folds
ValeraB96: raises 1800 to 3600
PhatAction09: folds
odanilolm: folds
gembrian1983: folds
thereaper2u: folds
McLci: folds
Uncalled bet (1800) returned to ValeraB96
ValeraB96 collected 6300 from pot
ValeraB96: doesn't show hand
*** SUMMARY ***
Total pot 6300 | Rake 0
Seat 1: odanilolm folded before Flop (didn't bet)
Seat 2: gembrian1983 (button) folded before Flop (didn't bet)
Seat 3: thereaper2u (small blind) folded before Flop
Seat 4: McLci (big blind) folded before Flop
Seat 6: oldyellowbricks folded before Flop (didn't bet)
Seat 7: phpro folded before Flop (didn't bet)
Seat 8: ValeraB96 collected (6300)
Seat 9: PhatAction09 folded before Flop (didn't bet)


*********** # 194 **************
PokerStars Hand #257047593999: Tournament #3910307458, $0.98+$0.12 USD Hold'em No Limit - Level XXI (900/1800) - 2025/07/22 13:07:32 ET
Table '3910307458 19' 9-max Seat #3 is the button
Seat 1: odanilolm (15920 in chips)
Seat 2: gembrian1983 (9394 in chips)
Seat 3: thereaper2u (38837 in chips)
Seat 4: McLci (46063 in chips)
Seat 6: oldyellowbricks (121704 in chips)
Seat 7: phpro (50080 in chips)
Seat 8: ValeraB96 (82455 in chips)
Seat 9: PhatAction09 (62584 in chips)
odanilolm: posts the ante 225
gembrian1983: posts the ante 225
thereaper2u: posts the ante 225
McLci: posts the ante 225
oldyellowbricks: posts the ante 225
phpro: posts the ante 225
ValeraB96: posts the ante 225
PhatAction09: posts the ante 225
McLci: posts small blind 900
oldyellowbricks: posts big blind 1800
*** HOLE CARDS ***
Dealt to phpro [7d 6c]
phpro: folds
ValeraB96: folds
PhatAction09: folds
odanilolm: folds
gembrian1983: raises 7369 to 9169 and is all-in
thereaper2u: folds
McLci: folds
oldyellowbricks: folds
Uncalled bet (7369) returned to gembrian1983
gembrian1983 collected 6300 from pot
*** SUMMARY ***
Total pot 6300 | Rake 0
Seat 1: odanilolm folded before Flop (didn't bet)
Seat 2: gembrian1983 collected (6300)
Seat 3: thereaper2u (button) folded before Flop (didn't bet)
Seat 4: McLci (small blind) folded before Flop
Seat 6: oldyellowbricks (big blind) folded before Flop
Seat 7: phpro folded before Flop (didn't bet)
Seat 8: ValeraB96 folded before Flop (didn't bet)
Seat 9: PhatAction09 folded before Flop (didn't bet)


*********** # 195 **************
PokerStars Hand #257047602400: Tournament #3910307458, $0.98+$0.12 USD Hold'em No Limit - Level XXI (900/1800) - 2025/07/22 13:08:16 ET
Table '3910307458 19' 9-max Seat #4 is the button
Seat 1: odanilolm (15695 in chips)
Seat 2: gembrian1983 (13669 in chips)
Seat 3: thereaper2u (38612 in chips)
Seat 4: McLci (44938 in chips)
Seat 6: oldyellowbricks (119679 in chips)
Seat 7: phpro (49855 in chips)
Seat 8: ValeraB96 (82230 in chips)
Seat 9: PhatAction09 (62359 in chips)
odanilolm: posts the ante 225
gembrian1983: posts the ante 225
thereaper2u: posts the ante 225
McLci: posts the ante 225
oldyellowbricks: posts the ante 225
phpro: posts the ante 225
ValeraB96: posts the ante 225
PhatAction09: posts the ante 225
oldyellowbricks: posts small blind 900
phpro: posts big blind 1800
*** HOLE CARDS ***
Dealt to phpro [5c 2s]
ValeraB96: folds
PhatAction09: folds
odanilolm: folds
gembrian1983: folds
thereaper2u: raises 6300 to 8100
McLci: folds
oldyellowbricks is disconnected
oldyellowbricks is connected
oldyellowbricks is connected
oldyellowbricks: raises 9900 to 18000
phpro: folds
thereaper2u: calls 9900
*** FLOP *** [Ks 8d 2c]
oldyellowbricks: bets 28800
thereaper2u: calls 20387 and is all-in
Uncalled bet (8413) returned to oldyellowbricks
*** TURN *** [Ks 8d 2c] [8h]
*** RIVER *** [Ks 8d 2c 8h] [6c]
*** SHOW DOWN ***
oldyellowbricks: shows [Qc Ac] (a pair of Eights)
thereaper2u: shows [7c 8c] (three of a kind, Eights)
thereaper2u collected 80374 from pot
*** SUMMARY ***
Total pot 80374 | Rake 0
Board [Ks 8d 2c 8h 6c]
Seat 1: odanilolm folded before Flop (didn't bet)
Seat 2: gembrian1983 folded before Flop (didn't bet)
Seat 3: thereaper2u showed [7c 8c] and won (80374) with three of a kind, Eights
Seat 4: McLci (button) folded before Flop (didn't bet)
Seat 6: oldyellowbricks (small blind) showed [Qc Ac] and lost with a pair of Eights
Seat 7: phpro (big blind) folded before Flop
Seat 8: ValeraB96 folded before Flop (didn't bet)
Seat 9: PhatAction09 folded before Flop (didn't bet)


*********** # 196 **************
PokerStars Hand #257047614986: Tournament #3910307458, $0.98+$0.12 USD Hold'em No Limit - Level XXI (900/1800) - 2025/07/22 13:09:22 ET
Table '3910307458 19' 9-max Seat #6 is the button
Seat 1: odanilolm (15470 in chips)
Seat 2: gembrian1983 (13444 in chips)
Seat 3: thereaper2u (80374 in chips)
Seat 4: McLci (44713 in chips)
Seat 6: oldyellowbricks (81067 in chips)
Seat 7: phpro (47830 in chips)
Seat 8: ValeraB96 (82005 in chips)
Seat 9: PhatAction09 (62134 in chips)
odanilolm: posts the ante 225
gembrian1983: posts the ante 225
thereaper2u: posts the ante 225
McLci: posts the ante 225
oldyellowbricks: posts the ante 225
phpro: posts the ante 225
ValeraB96: posts the ante 225
PhatAction09: posts the ante 225
phpro: posts small blind 900
ValeraB96: posts big blind 1800
*** HOLE CARDS ***
Dealt to phpro [As 3s]
PhatAction09: folds
odanilolm is disconnected
odanilolm has timed out
odanilolm: folds
odanilolm is sitting out
odanilolm is disconnected
odanilolm has returned
gembrian1983: folds
thereaper2u: folds
McLci: folds
oldyellowbricks: raises 1800 to 3600
phpro: calls 2700
ValeraB96: calls 1800
*** FLOP *** [Qs 8s 9s]
phpro: checks
ValeraB96: checks
oldyellowbricks: checks
*** TURN *** [Qs 8s 9s] [Ad]
phpro: bets 4158
ValeraB96: folds
oldyellowbricks: folds
Uncalled bet (4158) returned to phpro
phpro collected 12600 from pot
phpro: doesn't show hand
*** SUMMARY ***
Total pot 12600 | Rake 0
Board [Qs 8s 9s Ad]
Seat 1: odanilolm folded before Flop (didn't bet)
Seat 2: gembrian1983 folded before Flop (didn't bet)
Seat 3: thereaper2u folded before Flop (didn't bet)
Seat 4: McLci folded before Flop (didn't bet)
Seat 6: oldyellowbricks (button) folded on the Turn
Seat 7: phpro (small blind) collected (12600)
Seat 8: ValeraB96 (big blind) folded on the Turn
Seat 9: PhatAction09 folded before Flop (didn't bet)


*********** # 197 **************
PokerStars Hand #257047629687: Tournament #3910307458, $0.98+$0.12 USD Hold'em No Limit - Level XXII (1000/2000) - 2025/07/22 13:10:38 ET
Table '3910307458 19' 9-max Seat #7 is the button
Seat 1: odanilolm (15245 in chips)
Seat 2: gembrian1983 (13219 in chips)
Seat 3: thereaper2u (80149 in chips)
Seat 4: McLci (44488 in chips)
Seat 6: oldyellowbricks (77242 in chips)
Seat 7: phpro (56605 in chips)
Seat 8: ValeraB96 (78180 in chips)
Seat 9: PhatAction09 (61909 in chips)
odanilolm: posts the ante 250
gembrian1983: posts the ante 250
thereaper2u: posts the ante 250
McLci: posts the ante 250
oldyellowbricks: posts the ante 250
phpro: posts the ante 250
ValeraB96: posts the ante 250
PhatAction09: posts the ante 250
ValeraB96: posts small blind 1000
PhatAction09: posts big blind 2000
*** HOLE CARDS ***
Dealt to phpro [3d 8h]
odanilolm: folds
gembrian1983: folds
thereaper2u: folds
McLci: folds
oldyellowbricks: raises 2000 to 4000
phpro: folds
ValeraB96: folds
PhatAction09: folds
Uncalled bet (2000) returned to oldyellowbricks
oldyellowbricks collected 7000 from pot
oldyellowbricks: doesn't show hand
*** SUMMARY ***
Total pot 7000 | Rake 0
Seat 1: odanilolm folded before Flop (didn't bet)
Seat 2: gembrian1983 folded before Flop (didn't bet)
Seat 3: thereaper2u folded before Flop (didn't bet)
Seat 4: McLci folded before Flop (didn't bet)
Seat 6: oldyellowbricks collected (7000)
Seat 7: phpro (button) folded before Flop (didn't bet)
Seat 8: ValeraB96 (small blind) folded before Flop
Seat 9: PhatAction09 (big blind) folded before Flop


*********** # 198 **************
PokerStars Hand #257047637595: Tournament #3910307458, $0.98+$0.12 USD Hold'em No Limit - Level XXII (1000/2000) - 2025/07/22 13:11:19 ET
Table '3910307458 19' 9-max Seat #8 is the button
Seat 1: odanilolm (14995 in chips)
Seat 2: gembrian1983 (12969 in chips)
Seat 3: thereaper2u (79899 in chips)
Seat 4: McLci (44238 in chips)
Seat 6: oldyellowbricks (81992 in chips)
Seat 7: phpro (56355 in chips)
Seat 8: ValeraB96 (76930 in chips)
Seat 9: PhatAction09 (59659 in chips)
odanilolm: posts the ante 250
gembrian1983: posts the ante 250
thereaper2u: posts the ante 250
McLci: posts the ante 250
oldyellowbricks: posts the ante 250
phpro: posts the ante 250
ValeraB96: posts the ante 250
PhatAction09: posts the ante 250
PhatAction09: posts small blind 1000
odanilolm: posts big blind 2000
*** HOLE CARDS ***
Dealt to phpro [Ts 7h]
gembrian1983: folds
thereaper2u: folds
McLci: raises 2000 to 4000
oldyellowbricks: folds
phpro: folds
ValeraB96: folds
PhatAction09: raises 55409 to 59409 and is all-in
odanilolm: folds
McLci: folds
Uncalled bet (55409) returned to PhatAction09
PhatAction09 collected 12000 from pot
PhatAction09: doesn't show hand
*** SUMMARY ***
Total pot 12000 | Rake 0
Seat 1: odanilolm (big blind) folded before Flop
Seat 2: gembrian1983 folded before Flop (didn't bet)
Seat 3: thereaper2u folded before Flop (didn't bet)
Seat 4: McLci folded before Flop
Seat 6: oldyellowbricks folded before Flop (didn't bet)
Seat 7: phpro folded before Flop (didn't bet)
Seat 8: ValeraB96 (button) folded before Flop (didn't bet)
Seat 9: PhatAction09 (small blind) collected (12000)


*********** # 199 **************
PokerStars Hand #257047647533: Tournament #3910307458, $0.98+$0.12 USD Hold'em No Limit - Level XXII (1000/2000) - 2025/07/22 13:12:10 ET
Table '3910307458 19' 9-max Seat #9 is the button
Seat 1: odanilolm (12745 in chips)
Seat 2: gembrian1983 (12719 in chips)
Seat 3: thereaper2u (79649 in chips)
Seat 4: McLci (39988 in chips)
Seat 6: oldyellowbricks (81742 in chips)
Seat 7: phpro (56105 in chips)
Seat 8: ValeraB96 (76680 in chips)
Seat 9: PhatAction09 (67409 in chips)
odanilolm: posts the ante 250
gembrian1983: posts the ante 250
thereaper2u: posts the ante 250
McLci: posts the ante 250
oldyellowbricks: posts the ante 250
phpro: posts the ante 250
ValeraB96: posts the ante 250
PhatAction09: posts the ante 250
odanilolm: posts small blind 1000
gembrian1983: posts big blind 2000
*** HOLE CARDS ***
Dealt to phpro [Ad Tc]
thereaper2u: folds
McLci: folds
oldyellowbricks: folds
phpro: raises 2000 to 4000
ValeraB96: folds
PhatAction09: folds
odanilolm: folds
gembrian1983: folds
Uncalled bet (2000) returned to phpro
phpro collected 7000 from pot
phpro: doesn't show hand
*** SUMMARY ***
Total pot 7000 | Rake 0
Seat 1: odanilolm (small blind) folded before Flop
Seat 2: gembrian1983 (big blind) folded before Flop
Seat 3: thereaper2u folded before Flop (didn't bet)
Seat 4: McLci folded before Flop (didn't bet)
Seat 6: oldyellowbricks folded before Flop (didn't bet)
Seat 7: phpro collected (7000)
Seat 8: ValeraB96 folded before Flop (didn't bet)
Seat 9: PhatAction09 (button) folded before Flop (didn't bet)


*********** # 200 **************
PokerStars Hand #257047653989: Tournament #3910307458, $0.98+$0.12 USD Hold'em No Limit - Level XXII (1000/2000) - 2025/07/22 13:12:43 ET
Table '3910307458 19' 9-max Seat #1 is the button
Seat 1: odanilolm (11495 in chips)
Seat 2: gembrian1983 (10469 in chips)
Seat 3: thereaper2u (79399 in chips)
Seat 4: McLci (39738 in chips)
Seat 6: oldyellowbricks (81492 in chips)
Seat 7: phpro (60855 in chips)
Seat 8: ValeraB96 (76430 in chips)
Seat 9: PhatAction09 (67159 in chips)
odanilolm: posts the ante 250
gembrian1983: posts the ante 250
thereaper2u: posts the ante 250
McLci: posts the ante 250
oldyellowbricks: posts the ante 250
phpro: posts the ante 250
ValeraB96: posts the ante 250
PhatAction09: posts the ante 250
gembrian1983: posts small blind 1000
thereaper2u: posts big blind 2000
*** HOLE CARDS ***
Dealt to phpro [Qs As]
McLci: folds
oldyellowbricks: folds
phpro: raises 2000 to 4000
ValeraB96: folds
PhatAction09: folds
odanilolm: raises 7245 to 11245 and is all-in
gembrian1983: folds
thereaper2u: folds
phpro: calls 7245
*** FLOP *** [3s 5c 5h]
*** TURN *** [3s 5c 5h] [Jd]
*** RIVER *** [3s 5c 5h Jd] [9d]
*** SHOW DOWN ***
phpro: shows [Qs As] (a pair of Fives)
odanilolm: shows [Ks Qh] (a pair of Fives - lower kicker)
phpro collected 27490 from pot
odanilolm finished the tournament in 17th place and received $3.88.
*** SUMMARY ***
Total pot 27490 | Rake 0
Board [3s 5c 5h Jd 9d]
Seat 1: odanilolm (button) showed [Ks Qh] and lost with a pair of Fives
Seat 2: gembrian1983 (small blind) folded before Flop
Seat 3: thereaper2u (big blind) folded before Flop
Seat 4: McLci folded before Flop (didn't bet)
Seat 6: oldyellowbricks folded before Flop (didn't bet)
Seat 7: phpro showed [Qs As] and won (27490) with a pair of Fives
Seat 8: ValeraB96 folded before Flop (didn't bet)
Seat 9: PhatAction09 folded before Flop (didn't bet)


*********** # 201 **************
PokerStars Hand #257047664564: Tournament #3910307458, $0.98+$0.12 USD Hold'em No Limit - Level XXII (1000/2000) - 2025/07/22 13:13:38 ET
Table '3910307458 19' 9-max Seat #2 is the button
Seat 2: gembrian1983 (9219 in chips)
Seat 3: thereaper2u (77149 in chips)
Seat 4: McLci (39488 in chips)
Seat 6: oldyellowbricks (81242 in chips)
Seat 7: phpro (76850 in chips)
Seat 8: ValeraB96 (76180 in chips)
Seat 9: PhatAction09 (66909 in chips)
gembrian1983: posts the ante 250
thereaper2u: posts the ante 250
McLci: posts the ante 250
oldyellowbricks: posts the ante 250
phpro: posts the ante 250
ValeraB96: posts the ante 250
PhatAction09: posts the ante 250
thereaper2u: posts small blind 1000
McLci: posts big blind 2000
*** HOLE CARDS ***
Dealt to phpro [4c 2c]
oldyellowbricks: folds
phpro: folds
ValeraB96: folds
oldyellowbricks is disconnected
PhatAction09: folds
xxAlHixx is disconnected
gembrian1983: folds
thereaper2u: raises 5750 to 7750
McLci: folds
Uncalled bet (5750) returned to thereaper2u
thereaper2u collected 5750 from pot
thereaper2u: doesn't show hand
*** SUMMARY ***
Total pot 5750 | Rake 0
Seat 2: gembrian1983 (button) folded before Flop (didn't bet)
Seat 3: thereaper2u (small blind) collected (5750)
Seat 4: McLci (big blind) folded before Flop
Seat 6: oldyellowbricks folded before Flop (didn't bet)
Seat 7: phpro folded before Flop (didn't bet)
Seat 8: ValeraB96 folded before Flop (didn't bet)
Seat 9: PhatAction09 folded before Flop (didn't bet)


*********** # 202 **************
PokerStars Hand #257047671083: Tournament #3910307458, $0.98+$0.12 USD Hold'em No Limit - Level XXII (1000/2000) - 2025/07/22 13:14:11 ET
Table '3910307458 19' 9-max Seat #3 is the button
Seat 1: xxAlHixx (16334 in chips)
Seat 2: gembrian1983 (8969 in chips)
Seat 3: thereaper2u (80649 in chips)
Seat 4: McLci (37238 in chips)
Seat 6: oldyellowbricks (80992 in chips)
Seat 7: phpro (76600 in chips)
Seat 8: ValeraB96 (75930 in chips)
Seat 9: PhatAction09 (66659 in chips)
xxAlHixx: posts the ante 250
gembrian1983: posts the ante 250
thereaper2u: posts the ante 250
McLci: posts the ante 250
oldyellowbricks: posts the ante 250
phpro: posts the ante 250
ValeraB96: posts the ante 250
PhatAction09: posts the ante 250
McLci: posts small blind 1000
oldyellowbricks: posts big blind 2000
*** HOLE CARDS ***
Dealt to phpro [Ks 6h]
oldyellowbricks is disconnected
phpro: folds
ValeraB96: folds
PhatAction09: raises 2500 to 4500
xxAlHixx: folds
gembrian1983: folds
thereaper2u: folds
McLci: calls 3500
oldyellowbricks: calls 2500
*** FLOP *** [Tc 5h 5d]
McLci: checks
oldyellowbricks: checks
PhatAction09: bets 6000
McLci: folds
oldyellowbricks: calls 6000
*** TURN *** [Tc 5h 5d] [3c]
oldyellowbricks: checks
PhatAction09: bets 10000
oldyellowbricks: calls 10000
*** RIVER *** [Tc 5h 5d 3c] [Qd]
oldyellowbricks: checks
PhatAction09: checks
*** SHOW DOWN ***
oldyellowbricks: shows [Ts 5s] (a full house, Fives full of Tens)
PhatAction09: mucks hand
oldyellowbricks collected 47500 from pot
*** SUMMARY ***
Total pot 47500 | Rake 0
Board [Tc 5h 5d 3c Qd]
Seat 1: xxAlHixx folded before Flop (didn't bet)
Seat 2: gembrian1983 folded before Flop (didn't bet)
Seat 3: thereaper2u (button) folded before Flop (didn't bet)
Seat 4: McLci (small blind) folded on the Flop
Seat 6: oldyellowbricks (big blind) showed [Ts 5s] and won (47500) with a full house, Fives full of Tens
Seat 7: phpro folded before Flop (didn't bet)
Seat 8: ValeraB96 folded before Flop (didn't bet)
Seat 9: PhatAction09 mucked [Ad Td]


*********** # 203 **************
PokerStars Hand #257047687171: Tournament #3910307458, $0.98+$0.12 USD Hold'em No Limit - Level XXII (1000/2000) - 2025/07/22 13:15:35 ET
Table '3910307458 19' 9-max Seat #4 is the button
Seat 1: xxAlHixx (16084 in chips)
Seat 2: gembrian1983 (8719 in chips)
Seat 3: thereaper2u (80399 in chips)
Seat 4: McLci (32488 in chips)
Seat 6: oldyellowbricks (107742 in chips)
Seat 7: phpro (76350 in chips)
Seat 8: ValeraB96 (75680 in chips)
Seat 9: PhatAction09 (45909 in chips)
xxAlHixx: posts the ante 250
gembrian1983: posts the ante 250
thereaper2u: posts the ante 250
McLci: posts the ante 250
oldyellowbricks: posts the ante 250
phpro: posts the ante 250
ValeraB96: posts the ante 250
PhatAction09: posts the ante 250
oldyellowbricks: posts small blind 1000
phpro: posts big blind 2000
*** HOLE CARDS ***
Dealt to phpro [Kc Kd]
ValeraB96: folds
PhatAction09: folds
xxAlHixx: raises 13834 to 15834 and is all-in
gembrian1983: folds
thereaper2u: folds
McLci: folds
oldyellowbricks: folds
phpro: calls 13834
*** FLOP *** [4h 4d 8h]
*** TURN *** [4h 4d 8h] [5s]
*** RIVER *** [4h 4d 8h 5s] [6s]
*** SHOW DOWN ***
phpro: shows [Kc Kd] (two pair, Kings and Fours)
xxAlHixx: shows [7c 7h] (a straight, Four to Eight)
xxAlHixx collected 34668 from pot
*** SUMMARY ***
Total pot 34668 | Rake 0
Board [4h 4d 8h 5s 6s]
Seat 1: xxAlHixx showed [7c 7h] and won (34668) with a straight, Four to Eight
Seat 2: gembrian1983 folded before Flop (didn't bet)
Seat 3: thereaper2u folded before Flop (didn't bet)
Seat 4: McLci (button) folded before Flop (didn't bet)
Seat 6: oldyellowbricks (small blind) folded before Flop
Seat 7: phpro (big blind) showed [Kc Kd] and lost with two pair, Kings and Fours
Seat 8: ValeraB96 folded before Flop (didn't bet)
Seat 9: PhatAction09 folded before Flop (didn't bet)


*********** # 204 **************
PokerStars Hand #257047691287: Tournament #3910307458, $0.98+$0.12 USD Hold'em No Limit - Level XXII (1000/2000) - 2025/07/22 13:15:56 ET
Table '3910307458 19' 9-max Seat #6 is the button
Seat 1: xxAlHixx (34668 in chips)
Seat 2: gembrian1983 (8469 in chips)
Seat 3: thereaper2u (80149 in chips)
Seat 4: McLci (32238 in chips)
Seat 6: oldyellowbricks (106492 in chips)
Seat 7: phpro (60266 in chips)
Seat 8: ValeraB96 (75430 in chips)
Seat 9: PhatAction09 (45659 in chips)
xxAlHixx: posts the ante 250
gembrian1983: posts the ante 250
thereaper2u: posts the ante 250
McLci: posts the ante 250
oldyellowbricks: posts the ante 250
phpro: posts the ante 250
ValeraB96: posts the ante 250
PhatAction09: posts the ante 250
phpro: posts small blind 1000
ValeraB96: posts big blind 2000
*** HOLE CARDS ***
Dealt to phpro [5c 2d]
PhatAction09: folds
xxAlHixx: folds
gembrian1983 has timed out
gembrian1983: folds
gembrian1983 is sitting out
thereaper2u: folds
McLci: folds
gembrian1983 has returned
oldyellowbricks: raises 2000 to 4000
phpro: folds
ValeraB96: calls 2000
*** FLOP *** [5h 8c 9s]
ValeraB96: checks
oldyellowbricks: bets 8800
ValeraB96: folds
Uncalled bet (8800) returned to oldyellowbricks
oldyellowbricks collected 11000 from pot
oldyellowbricks: doesn't show hand
*** SUMMARY ***
Total pot 11000 | Rake 0
Board [5h 8c 9s]
Seat 1: xxAlHixx folded before Flop (didn't bet)
Seat 2: gembrian1983 folded before Flop (didn't bet)
Seat 3: thereaper2u folded before Flop (didn't bet)
Seat 4: McLci folded before Flop (didn't bet)
Seat 6: oldyellowbricks (button) collected (11000)
Seat 7: phpro (small blind) folded before Flop
Seat 8: ValeraB96 (big blind) folded on the Flop
Seat 9: PhatAction09 folded before Flop (didn't bet)


*********** # 205 **************
PokerStars Hand #257047700272: Tournament #3910307458, $0.98+$0.12 USD Hold'em No Limit - Level XXII (1000/2000) - 2025/07/22 13:16:43 ET
Table '3910307458 19' 9-max Seat #7 is the button
Seat 1: xxAlHixx (34418 in chips)
Seat 2: gembrian1983 (8219 in chips)
Seat 3: thereaper2u (79899 in chips)
Seat 4: McLci (31988 in chips)
Seat 6: oldyellowbricks (113242 in chips)
Seat 7: phpro (59016 in chips)
Seat 8: ValeraB96 (71180 in chips)
Seat 9: PhatAction09 (45409 in chips)
xxAlHixx: posts the ante 250
gembrian1983: posts the ante 250
thereaper2u: posts the ante 250
McLci: posts the ante 250
oldyellowbricks: posts the ante 250
phpro: posts the ante 250
ValeraB96: posts the ante 250
PhatAction09: posts the ante 250
ValeraB96: posts small blind 1000
PhatAction09: posts big blind 2000
*** HOLE CARDS ***
Dealt to phpro [5s 3s]
xxAlHixx: folds
gembrian1983: folds
thereaper2u: raises 7000 to 9000
McLci: folds
oldyellowbricks: folds
phpro: folds
ValeraB96: folds
PhatAction09: raises 36159 to 45159 and is all-in
thereaper2u: folds
Uncalled bet (36159) returned to PhatAction09
PhatAction09 collected 21000 from pot
PhatAction09: doesn't show hand
*** SUMMARY ***
Total pot 21000 | Rake 0
Seat 1: xxAlHixx folded before Flop (didn't bet)
Seat 2: gembrian1983 folded before Flop (didn't bet)
Seat 3: thereaper2u folded before Flop
Seat 4: McLci folded before Flop (didn't bet)
Seat 6: oldyellowbricks folded before Flop (didn't bet)
Seat 7: phpro (button) folded before Flop (didn't bet)
Seat 8: ValeraB96 (small blind) folded before Flop
Seat 9: PhatAction09 (big blind) collected (21000)


*********** # 206 **************
PokerStars Hand #257047708953: Tournament #3910307458, $0.98+$0.12 USD Hold'em No Limit - Level XXII (1000/2000) - 2025/07/22 13:17:29 ET
Table '3910307458 19' 9-max Seat #8 is the button
Seat 1: xxAlHixx (34168 in chips)
Seat 2: gembrian1983 (7969 in chips)
Seat 3: thereaper2u (70649 in chips)
Seat 4: McLci (31738 in chips)
Seat 6: oldyellowbricks (112992 in chips)
Seat 7: phpro (58766 in chips)
Seat 8: ValeraB96 (69930 in chips)
Seat 9: PhatAction09 (57159 in chips)
xxAlHixx: posts the ante 250
gembrian1983: posts the ante 250
thereaper2u: posts the ante 250
McLci: posts the ante 250
oldyellowbricks: posts the ante 250
phpro: posts the ante 250
ValeraB96: posts the ante 250
PhatAction09: posts the ante 250
PhatAction09: posts small blind 1000
xxAlHixx: posts big blind 2000
*** HOLE CARDS ***
Dealt to phpro [6s Qd]
gembrian1983: raises 5719 to 7719 and is all-in
thereaper2u: folds
McLci: folds
oldyellowbricks: folds
phpro: folds
ValeraB96: folds
PhatAction09: folds
xxAlHixx: calls 5719
*** FLOP *** [Jd Td 6c]
*** TURN *** [Jd Td 6c] [5d]
*** RIVER *** [Jd Td 6c 5d] [2s]
*** SHOW DOWN ***
xxAlHixx: shows [4c 4d] (a pair of Fours)
gembrian1983: shows [9h 9d] (a pair of Nines)
gembrian1983 collected 18438 from pot
*** SUMMARY ***
Total pot 18438 | Rake 0
Board [Jd Td 6c 5d 2s]
Seat 1: xxAlHixx (big blind) showed [4c 4d] and lost with a pair of Fours
Seat 2: gembrian1983 showed [9h 9d] and won (18438) with a pair of Nines
Seat 3: thereaper2u folded before Flop (didn't bet)
Seat 4: McLci folded before Flop (didn't bet)
Seat 6: oldyellowbricks folded before Flop (didn't bet)
Seat 7: phpro folded before Flop (didn't bet)
Seat 8: ValeraB96 (button) folded before Flop (didn't bet)
Seat 9: PhatAction09 (small blind) folded before Flop


*********** # 207 **************
PokerStars Hand #257047713283: Tournament #3910307458, $0.98+$0.12 USD Hold'em No Limit - Level XXII (1000/2000) - 2025/07/22 13:17:52 ET
Table '3910307458 19' 9-max Seat #9 is the button
Seat 1: xxAlHixx (26199 in chips)
Seat 2: gembrian1983 (18438 in chips)
Seat 3: thereaper2u (70399 in chips)
Seat 4: McLci (31488 in chips)
Seat 6: oldyellowbricks (112742 in chips)
Seat 7: phpro (58516 in chips)
Seat 8: ValeraB96 (69680 in chips)
Seat 9: PhatAction09 (55909 in chips)
xxAlHixx: posts the ante 250
gembrian1983: posts the ante 250
thereaper2u: posts the ante 250
McLci: posts the ante 250
oldyellowbricks: posts the ante 250
phpro: posts the ante 250
ValeraB96: posts the ante 250
PhatAction09: posts the ante 250
xxAlHixx: posts small blind 1000
gembrian1983: posts big blind 2000
*** HOLE CARDS ***
Dealt to phpro [Qh 4s]
thereaper2u: raises 7000 to 9000
McLci: folds
oldyellowbricks: folds
phpro: folds
ValeraB96: folds
PhatAction09: folds
xxAlHixx: folds
gembrian1983: folds
Uncalled bet (7000) returned to thereaper2u
thereaper2u collected 7000 from pot
thereaper2u: doesn't show hand
*** SUMMARY ***
Total pot 7000 | Rake 0
Seat 1: xxAlHixx (small blind) folded before Flop
Seat 2: gembrian1983 (big blind) folded before Flop
Seat 3: thereaper2u collected (7000)
Seat 4: McLci folded before Flop (didn't bet)
Seat 6: oldyellowbricks folded before Flop (didn't bet)
Seat 7: phpro folded before Flop (didn't bet)
Seat 8: ValeraB96 folded before Flop (didn't bet)
Seat 9: PhatAction09 (button) folded before Flop (didn't bet)


*********** # 208 **************
PokerStars Hand #257047720902: Tournament #3910307458, $0.98+$0.12 USD Hold'em No Limit - Level XXII (1000/2000) - 2025/07/22 13:18:33 ET
Table '3910307458 19' 9-max Seat #1 is the button
Seat 1: xxAlHixx (24949 in chips)
Seat 2: gembrian1983 (16188 in chips)
Seat 3: thereaper2u (75149 in chips)
Seat 4: McLci (31238 in chips)
Seat 6: oldyellowbricks (112492 in chips)
Seat 7: phpro (58266 in chips)
Seat 8: ValeraB96 (69430 in chips)
Seat 9: PhatAction09 (55659 in chips)
xxAlHixx: posts the ante 250
gembrian1983: posts the ante 250
thereaper2u: posts the ante 250
McLci: posts the ante 250
oldyellowbricks: posts the ante 250
phpro: posts the ante 250
ValeraB96: posts the ante 250
PhatAction09: posts the ante 250
gembrian1983: posts small blind 1000
thereaper2u: posts big blind 2000
*** HOLE CARDS ***
Dealt to phpro [Kc Ts]
McLci: folds
oldyellowbricks: folds
phpro: folds
ValeraB96: folds
PhatAction09: folds
xxAlHixx: folds
gembrian1983: folds
Uncalled bet (1000) returned to thereaper2u
thereaper2u collected 4000 from pot
thereaper2u: doesn't show hand
*** SUMMARY ***
Total pot 4000 | Rake 0
Seat 1: xxAlHixx (button) folded before Flop (didn't bet)
Seat 2: gembrian1983 (small blind) folded before Flop
Seat 3: thereaper2u (big blind) collected (4000)
Seat 4: McLci folded before Flop (didn't bet)
Seat 6: oldyellowbricks folded before Flop (didn't bet)
Seat 7: phpro folded before Flop (didn't bet)
Seat 8: ValeraB96 folded before Flop (didn't bet)
Seat 9: PhatAction09 folded before Flop (didn't bet)


*********** # 209 **************
PokerStars Hand #257047726285: Tournament #3910307458, $0.98+$0.12 USD Hold'em No Limit - Level XXII (1000/2000) - 2025/07/22 13:19:01 ET
Table '3910307458 19' 9-max Seat #2 is the button
Seat 1: xxAlHixx (24699 in chips)
Seat 2: gembrian1983 (14938 in chips)
Seat 3: thereaper2u (77899 in chips)
Seat 4: McLci (30988 in chips)
Seat 6: oldyellowbricks (112242 in chips)
Seat 7: phpro (58016 in chips)
Seat 8: ValeraB96 (69180 in chips)
Seat 9: PhatAction09 (55409 in chips)
xxAlHixx: posts the ante 250
gembrian1983: posts the ante 250
thereaper2u: posts the ante 250
McLci: posts the ante 250
oldyellowbricks: posts the ante 250
phpro: posts the ante 250
ValeraB96: posts the ante 250
PhatAction09: posts the ante 250
thereaper2u: posts small blind 1000
McLci: posts big blind 2000
*** HOLE CARDS ***
Dealt to phpro [Js Jd]
oldyellowbricks: folds
phpro: raises 2000 to 4000
ValeraB96: folds
PhatAction09: folds
xxAlHixx: folds
gembrian1983: folds
thereaper2u: folds
McLci: raises 26738 to 30738 and is all-in
phpro: calls 26738
*** FLOP *** [6d Ts 8s]
*** TURN *** [6d Ts 8s] [3h]
*** RIVER *** [6d Ts 8s 3h] [6h]
*** SHOW DOWN ***
McLci: shows [Tc Th] (a full house, Tens full of Sixes)
phpro: shows [Js Jd] (two pair, Jacks and Sixes)
McLci collected 64476 from pot
*** SUMMARY ***
Total pot 64476 | Rake 0
Board [6d Ts 8s 3h 6h]
Seat 1: xxAlHixx folded before Flop (didn't bet)
Seat 2: gembrian1983 (button) folded before Flop (didn't bet)
Seat 3: thereaper2u (small blind) folded before Flop
Seat 4: McLci (big blind) showed [Tc Th] and won (64476) with a full house, Tens full of Sixes
Seat 6: oldyellowbricks folded before Flop (didn't bet)
Seat 7: phpro showed [Js Jd] and lost with two pair, Jacks and Sixes
Seat 8: ValeraB96 folded before Flop (didn't bet)
Seat 9: PhatAction09 folded before Flop (didn't bet)


*********** # 210 **************
PokerStars Hand #257047730877: Tournament #3910307458, $0.98+$0.12 USD Hold'em No Limit - Level XXII (1000/2000) - 2025/07/22 13:19:26 ET
Table '3910307458 19' 9-max Seat #3 is the button
Seat 1: xxAlHixx (24449 in chips)
Seat 2: gembrian1983 (14688 in chips)
Seat 3: thereaper2u (76649 in chips)
Seat 4: McLci (64476 in chips)
Seat 6: oldyellowbricks (111992 in chips)
Seat 7: phpro (27028 in chips)
Seat 8: ValeraB96 (68930 in chips)
Seat 9: PhatAction09 (55159 in chips)
xxAlHixx: posts the ante 250
gembrian1983: posts the ante 250
thereaper2u: posts the ante 250
McLci: posts the ante 250
oldyellowbricks: posts the ante 250
phpro: posts the ante 250
ValeraB96: posts the ante 250
PhatAction09: posts the ante 250
McLci: posts small blind 1000
oldyellowbricks: posts big blind 2000
*** HOLE CARDS ***
Dealt to phpro [8s 6s]
phpro: folds
ValeraB96: folds
PhatAction09: folds
xxAlHixx: folds
gembrian1983: folds
thereaper2u: raises 7000 to 9000
McLci: folds
oldyellowbricks: folds
Uncalled bet (7000) returned to thereaper2u
thereaper2u collected 7000 from pot
thereaper2u: doesn't show hand
*** SUMMARY ***
Total pot 7000 | Rake 0
Seat 1: xxAlHixx folded before Flop (didn't bet)
Seat 2: gembrian1983 folded before Flop (didn't bet)
Seat 3: thereaper2u (button) collected (7000)
Seat 4: McLci (small blind) folded before Flop
Seat 6: oldyellowbricks (big blind) folded before Flop
Seat 7: phpro folded before Flop (didn't bet)
Seat 8: ValeraB96 folded before Flop (didn't bet)
Seat 9: PhatAction09 folded before Flop (didn't bet)


*********** # 211 **************
PokerStars Hand #257047737228: Tournament #3910307458, $0.98+$0.12 USD Hold'em No Limit - Level XXIII (1200/2400) - 2025/07/22 13:20:00 ET
Table '3910307458 19' 9-max Seat #4 is the button
Seat 1: xxAlHixx (24199 in chips)
Seat 2: gembrian1983 (14438 in chips)
Seat 3: thereaper2u (81399 in chips)
Seat 4: McLci (63226 in chips)
Seat 6: oldyellowbricks (109742 in chips)
Seat 7: phpro (26778 in chips)
Seat 8: ValeraB96 (68680 in chips)
Seat 9: PhatAction09 (54909 in chips)
xxAlHixx: posts the ante 300
gembrian1983: posts the ante 300
thereaper2u: posts the ante 300
McLci: posts the ante 300
oldyellowbricks: posts the ante 300
phpro: posts the ante 300
ValeraB96: posts the ante 300
PhatAction09: posts the ante 300
oldyellowbricks: posts small blind 1200
phpro: posts big blind 2400
*** HOLE CARDS ***
Dealt to phpro [Kd 2s]
ValeraB96: folds
PhatAction09: folds
xxAlHixx: folds
gembrian1983: raises 11738 to 14138 and is all-in
thereaper2u: folds
McLci: folds
oldyellowbricks: folds
phpro: folds
Uncalled bet (11738) returned to gembrian1983
gembrian1983 collected 8400 from pot
*** SUMMARY ***
Total pot 8400 | Rake 0
Seat 1: xxAlHixx folded before Flop (didn't bet)
Seat 2: gembrian1983 collected (8400)
Seat 3: thereaper2u folded before Flop (didn't bet)
Seat 4: McLci (button) folded before Flop (didn't bet)
Seat 6: oldyellowbricks (small blind) folded before Flop
Seat 7: phpro (big blind) folded before Flop
Seat 8: ValeraB96 folded before Flop (didn't bet)
Seat 9: PhatAction09 folded before Flop (didn't bet)


*********** # 212 **************
PokerStars Hand #257047741646: Tournament #3910307458, $0.98+$0.12 USD Hold'em No Limit - Level XXIII (1200/2400) - 2025/07/22 13:20:24 ET
Table '3910307458 19' 9-max Seat #6 is the button
Seat 1: xxAlHixx (23899 in chips)
Seat 2: gembrian1983 (20138 in chips)
Seat 3: thereaper2u (81099 in chips)
Seat 4: McLci (62926 in chips)
Seat 6: oldyellowbricks (108242 in chips)
Seat 7: phpro (24078 in chips)
Seat 8: ValeraB96 (68380 in chips)
Seat 9: PhatAction09 (54609 in chips)
xxAlHixx: posts the ante 300
gembrian1983: posts the ante 300
thereaper2u: posts the ante 300
McLci: posts the ante 300
oldyellowbricks: posts the ante 300
phpro: posts the ante 300
ValeraB96: posts the ante 300
PhatAction09: posts the ante 300
phpro: posts small blind 1200
ValeraB96: posts big blind 2400
*** HOLE CARDS ***
Dealt to phpro [9s Ts]
PhatAction09: folds
xxAlHixx: raises 21199 to 23599 and is all-in
gembrian1983: folds
thereaper2u: folds
McLci: folds
oldyellowbricks: folds
phpro: folds
ValeraB96: folds
Uncalled bet (21199) returned to xxAlHixx
xxAlHixx collected 8400 from pot
xxAlHixx: doesn't show hand
*** SUMMARY ***
Total pot 8400 | Rake 0
Seat 1: xxAlHixx collected (8400)
Seat 2: gembrian1983 folded before Flop (didn't bet)
Seat 3: thereaper2u folded before Flop (didn't bet)
Seat 4: McLci folded before Flop (didn't bet)
Seat 6: oldyellowbricks (button) folded before Flop (didn't bet)
Seat 7: phpro (small blind) folded before Flop
Seat 8: ValeraB96 (big blind) folded before Flop
Seat 9: PhatAction09 folded before Flop (didn't bet)


*********** # 213 **************
PokerStars Hand #257047744604: Tournament #3910307458, $0.98+$0.12 USD Hold'em No Limit - Level XXIII (1200/2400) - 2025/07/22 13:20:40 ET
Table '3910307458 19' 9-max Seat #7 is the button
Seat 1: xxAlHixx (29599 in chips)
Seat 2: gembrian1983 (19838 in chips)
Seat 3: thereaper2u (80799 in chips)
Seat 4: McLci (62626 in chips)
Seat 6: oldyellowbricks (107942 in chips)
Seat 7: phpro (22578 in chips)
Seat 8: ValeraB96 (65680 in chips)
Seat 9: PhatAction09 (54309 in chips)
xxAlHixx: posts the ante 300
gembrian1983: posts the ante 300
thereaper2u: posts the ante 300
McLci: posts the ante 300
oldyellowbricks: posts the ante 300
phpro: posts the ante 300
ValeraB96: posts the ante 300
PhatAction09: posts the ante 300
ValeraB96: posts small blind 1200
PhatAction09: posts big blind 2400
*** HOLE CARDS ***
Dealt to phpro [Ac Tc]
xxAlHixx: folds
gembrian1983: folds
thereaper2u: folds
McLci: folds
oldyellowbricks: folds
phpro: raises 19878 to 22278 and is all-in
ValeraB96: raises 43102 to 65380 and is all-in
PhatAction09: folds
Uncalled bet (43102) returned to ValeraB96
*** FLOP *** [Jd Kc 4d]
*** TURN *** [Jd Kc 4d] [3s]
*** RIVER *** [Jd Kc 4d 3s] [Qd]
*** SHOW DOWN ***
ValeraB96: shows [Ad 9h] (high card Ace)
phpro: shows [Ac Tc] (a straight, Ten to Ace)
phpro collected 49356 from pot
*** SUMMARY ***
Total pot 49356 | Rake 0
Board [Jd Kc 4d 3s Qd]
Seat 1: xxAlHixx folded before Flop (didn't bet)
Seat 2: gembrian1983 folded before Flop (didn't bet)
Seat 3: thereaper2u folded before Flop (didn't bet)
Seat 4: McLci folded before Flop (didn't bet)
Seat 6: oldyellowbricks folded before Flop (didn't bet)
Seat 7: phpro (button) showed [Ac Tc] and won (49356) with a straight, Ten to Ace
Seat 8: ValeraB96 (small blind) showed [Ad 9h] and lost with high card Ace
Seat 9: PhatAction09 (big blind) folded before Flop


*********** # 214 **************
PokerStars Hand #257047750420: Tournament #3910307458, $0.98+$0.12 USD Hold'em No Limit - Level XXIII (1200/2400) - 2025/07/22 13:21:10 ET
Table '3910307458 19' 9-max Seat #8 is the button
Seat 1: xxAlHixx (29299 in chips)
Seat 2: gembrian1983 (19538 in chips)
Seat 3: thereaper2u (80499 in chips)
Seat 4: McLci (62326 in chips)
Seat 6: oldyellowbricks (107642 in chips)
Seat 7: phpro (49356 in chips)
Seat 8: ValeraB96 (43102 in chips)
Seat 9: PhatAction09 (51609 in chips)
xxAlHixx: posts the ante 300
gembrian1983: posts the ante 300
thereaper2u: posts the ante 300
McLci: posts the ante 300
oldyellowbricks: posts the ante 300
phpro: posts the ante 300
ValeraB96: posts the ante 300
PhatAction09: posts the ante 300
PhatAction09: posts small blind 1200
xxAlHixx: posts big blind 2400
*** HOLE CARDS ***
Dealt to phpro [Qd 7d]
gembrian1983: folds
thereaper2u: folds
McLci: folds
oldyellowbricks: folds
phpro: folds
ValeraB96: raises 2400 to 4800
PhatAction09: folds
xxAlHixx: folds
Uncalled bet (2400) returned to ValeraB96
ValeraB96 collected 8400 from pot
ValeraB96: doesn't show hand
*** SUMMARY ***
Total pot 8400 | Rake 0
Seat 1: xxAlHixx (big blind) folded before Flop
Seat 2: gembrian1983 folded before Flop (didn't bet)
Seat 3: thereaper2u folded before Flop (didn't bet)
Seat 4: McLci folded before Flop (didn't bet)
Seat 6: oldyellowbricks folded before Flop (didn't bet)
Seat 7: phpro folded before Flop (didn't bet)
Seat 8: ValeraB96 (button) collected (8400)
Seat 9: PhatAction09 (small blind) folded before Flop


*********** # 215 **************
PokerStars Hand #257047756433: Tournament #3910307458, $0.98+$0.12 USD Hold'em No Limit - Level XXIII (1200/2400) - 2025/07/22 13:21:42 ET
Table '3910307458 19' 9-max Seat #9 is the button
Seat 1: xxAlHixx (26599 in chips)
Seat 2: gembrian1983 (19238 in chips)
Seat 3: thereaper2u (80199 in chips)
Seat 4: McLci (62026 in chips)
Seat 6: oldyellowbricks (107342 in chips)
Seat 7: phpro (49056 in chips)
Seat 8: ValeraB96 (48802 in chips)
Seat 9: PhatAction09 (50109 in chips)
xxAlHixx: posts the ante 300
gembrian1983: posts the ante 300
thereaper2u: posts the ante 300
McLci: posts the ante 300
oldyellowbricks: posts the ante 300
phpro: posts the ante 300
ValeraB96: posts the ante 300
PhatAction09: posts the ante 300
xxAlHixx: posts small blind 1200
gembrian1983: posts big blind 2400
*** HOLE CARDS ***
Dealt to phpro [3d 3h]
thereaper2u: folds
McLci: folds
oldyellowbricks: folds
phpro: raises 2400 to 4800
ValeraB96: folds
PhatAction09: folds
xxAlHixx: folds
gembrian1983: folds
Uncalled bet (2400) returned to phpro
phpro collected 8400 from pot
phpro: doesn't show hand
*** SUMMARY ***
Total pot 8400 | Rake 0
Seat 1: xxAlHixx (small blind) folded before Flop
Seat 2: gembrian1983 (big blind) folded before Flop
Seat 3: thereaper2u folded before Flop (didn't bet)
Seat 4: McLci folded before Flop (didn't bet)
Seat 6: oldyellowbricks folded before Flop (didn't bet)
Seat 7: phpro collected (8400)
Seat 8: ValeraB96 folded before Flop (didn't bet)
Seat 9: PhatAction09 (button) folded before Flop (didn't bet)


*********** # 216 **************
PokerStars Hand #257047760038: Tournament #3910307458, $0.98+$0.12 USD Hold'em No Limit - Level XXIII (1200/2400) - 2025/07/22 13:22:01 ET
Table '3910307458 19' 9-max Seat #1 is the button
Seat 1: xxAlHixx (25099 in chips)
Seat 2: gembrian1983 (16538 in chips)
Seat 3: thereaper2u (79899 in chips)
Seat 4: McLci (61726 in chips)
Seat 6: oldyellowbricks (107042 in chips)
Seat 7: phpro (54756 in chips)
Seat 8: ValeraB96 (48502 in chips)
Seat 9: PhatAction09 (49809 in chips)
xxAlHixx: posts the ante 300
gembrian1983: posts the ante 300
thereaper2u: posts the ante 300
McLci: posts the ante 300
oldyellowbricks: posts the ante 300
phpro: posts the ante 300
ValeraB96: posts the ante 300
PhatAction09: posts the ante 300
gembrian1983: posts small blind 1200
thereaper2u: posts big blind 2400
*** HOLE CARDS ***
Dealt to phpro [Td 2c]
McLci: raises 2400 to 4800
oldyellowbricks: folds
phpro: folds
ValeraB96: folds
PhatAction09: folds
xxAlHixx: folds
gembrian1983: raises 11438 to 16238 and is all-in
thereaper2u: folds
McLci: calls 11438
*** FLOP *** [Jd Ts Qd]
*** TURN *** [Jd Ts Qd] [5s]
*** RIVER *** [Jd Ts Qd 5s] [Kh]
*** SHOW DOWN ***
gembrian1983: shows [Kd 7h] (a pair of Kings)
McLci: shows [9d 9s] (a straight, Nine to King)
McLci collected 37276 from pot
gembrian1983 finished the tournament in 15th place and received $3.88.
*** SUMMARY ***
Total pot 37276 | Rake 0
Board [Jd Ts Qd 5s Kh]
Seat 1: xxAlHixx (button) folded before Flop (didn't bet)
Seat 2: gembrian1983 (small blind) showed [Kd 7h] and lost with a pair of Kings
Seat 3: thereaper2u (big blind) folded before Flop
Seat 4: McLci showed [9d 9s] and won (37276) with a straight, Nine to King
Seat 6: oldyellowbricks folded before Flop (didn't bet)
Seat 7: phpro folded before Flop (didn't bet)
Seat 8: ValeraB96 folded before Flop (didn't bet)
Seat 9: PhatAction09 folded before Flop (didn't bet)


*********** # 217 **************
PokerStars Hand #257047768170: Tournament #3910307458, $0.98+$0.12 USD Hold'em No Limit - Level XXIII (1200/2400) - 2025/07/22 13:22:44 ET
Table '3910307458 19' 9-max Seat #3 is the button
Seat 1: xxAlHixx (24799 in chips)
Seat 3: thereaper2u (77199 in chips)
Seat 4: McLci (82464 in chips)
Seat 6: oldyellowbricks (106742 in chips)
Seat 7: phpro (54456 in chips)
Seat 8: ValeraB96 (48202 in chips)
Seat 9: PhatAction09 (49509 in chips)
xxAlHixx: posts the ante 300
thereaper2u: posts the ante 300
McLci: posts the ante 300
oldyellowbricks: posts the ante 300
phpro: posts the ante 300
ValeraB96: posts the ante 300
PhatAction09: posts the ante 300
McLci: posts small blind 1200
oldyellowbricks: posts big blind 2400
*** HOLE CARDS ***
Dealt to phpro [Js As]
phpro: raises 2400 to 4800
ValeraB96: folds
PhatAction09: folds
xxAlHixx: folds
thereaper2u: folds
McLci: folds
oldyellowbricks: raises 12000 to 16800
phpro: calls 12000
*** FLOP *** [6d 3h 2s]
oldyellowbricks: bets 9777
phpro: calls 9777
*** TURN *** [6d 3h 2s] [7c]
oldyellowbricks: bets 45163
phpro: folds
Uncalled bet (45163) returned to oldyellowbricks
oldyellowbricks collected 56454 from pot
oldyellowbricks: doesn't show hand
*** SUMMARY ***
Total pot 56454 | Rake 0
Board [6d 3h 2s 7c]
Seat 1: xxAlHixx folded before Flop (didn't bet)
Seat 3: thereaper2u (button) folded before Flop (didn't bet)
Seat 4: McLci (small blind) folded before Flop
Seat 6: oldyellowbricks (big blind) collected (56454)
Seat 7: phpro folded on the Turn
Seat 8: ValeraB96 folded before Flop (didn't bet)
Seat 9: PhatAction09 folded before Flop (didn't bet)


*********** # 218 **************
PokerStars Hand #257047776909: Tournament #3910307458, $0.98+$0.12 USD Hold'em No Limit - Level XXIII (1200/2400) - 2025/07/22 13:23:30 ET
Table '3910307458 19' 9-max Seat #4 is the button
Seat 1: xxAlHixx (24499 in chips)
Seat 3: thereaper2u (76899 in chips)
Seat 4: McLci (80964 in chips)
Seat 6: oldyellowbricks (136319 in chips)
Seat 7: phpro (27579 in chips)
Seat 8: ValeraB96 (47902 in chips)
Seat 9: PhatAction09 (49209 in chips)
xxAlHixx: posts the ante 300
thereaper2u: posts the ante 300
McLci: posts the ante 300
oldyellowbricks: posts the ante 300
phpro: posts the ante 300
ValeraB96: posts the ante 300
PhatAction09: posts the ante 300
oldyellowbricks: posts small blind 1200
phpro: posts big blind 2400
*** HOLE CARDS ***
Dealt to phpro [4h Ts]
ValeraB96: folds
PhatAction09: raises 46509 to 48909 and is all-in
xxAlHixx: folds
thereaper2u: folds
McLci: folds
oldyellowbricks: folds
phpro: folds
Uncalled bet (46509) returned to PhatAction09
PhatAction09 collected 8100 from pot
PhatAction09: doesn't show hand
*** SUMMARY ***
Total pot 8100 | Rake 0
Seat 1: xxAlHixx folded before Flop (didn't bet)
Seat 3: thereaper2u folded before Flop (didn't bet)
Seat 4: McLci (button) folded before Flop (didn't bet)
Seat 6: oldyellowbricks (small blind) folded before Flop
Seat 7: phpro (big blind) folded before Flop
Seat 8: ValeraB96 folded before Flop (didn't bet)
Seat 9: PhatAction09 collected (8100)


*********** # 219 **************
PokerStars Hand #257047781656: Tournament #3910307458, $0.98+$0.12 USD Hold'em No Limit - Level XXIII (1200/2400) - 2025/07/22 13:23:55 ET
Table '3910307458 19' 9-max Seat #6 is the button
Seat 1: xxAlHixx (24199 in chips)
Seat 3: thereaper2u (76599 in chips)
Seat 4: McLci (80664 in chips)
Seat 6: oldyellowbricks (134819 in chips)
Seat 7: phpro (24879 in chips)
Seat 8: ValeraB96 (47602 in chips)
Seat 9: PhatAction09 (54609 in chips)
xxAlHixx: posts the ante 300
thereaper2u: posts the ante 300
McLci: posts the ante 300
oldyellowbricks: posts the ante 300
phpro: posts the ante 300
ValeraB96: posts the ante 300
PhatAction09: posts the ante 300
phpro: posts small blind 1200
ValeraB96: posts big blind 2400
*** HOLE CARDS ***
Dealt to phpro [7d Ks]
PhatAction09: folds
xxAlHixx: raises 21499 to 23899 and is all-in
thereaper2u: folds
McLci: folds
oldyellowbricks: folds
phpro: folds
ValeraB96: folds
Uncalled bet (21499) returned to xxAlHixx
xxAlHixx collected 8100 from pot
xxAlHixx: doesn't show hand
*** SUMMARY ***
Total pot 8100 | Rake 0
Seat 1: xxAlHixx collected (8100)
Seat 3: thereaper2u folded before Flop (didn't bet)
Seat 4: McLci folded before Flop (didn't bet)
Seat 6: oldyellowbricks (button) folded before Flop (didn't bet)
Seat 7: phpro (small blind) folded before Flop
Seat 8: ValeraB96 (big blind) folded before Flop
Seat 9: PhatAction09 folded before Flop (didn't bet)


*********** # 220 **************
PokerStars Hand #257047785340: Tournament #3910307458, $0.98+$0.12 USD Hold'em No Limit - Level XXIII (1200/2400) - 2025/07/22 13:24:15 ET
Table '3910307458 19' 9-max Seat #7 is the button
Seat 1: xxAlHixx (29599 in chips)
Seat 3: thereaper2u (76299 in chips)
Seat 4: McLci (80364 in chips)
Seat 6: oldyellowbricks (134519 in chips)
Seat 7: phpro (23379 in chips)
Seat 8: ValeraB96 (44902 in chips)
Seat 9: PhatAction09 (54309 in chips)
xxAlHixx: posts the ante 300
thereaper2u: posts the ante 300
McLci: posts the ante 300
oldyellowbricks: posts the ante 300
phpro: posts the ante 300
ValeraB96: posts the ante 300
PhatAction09: posts the ante 300
ValeraB96: posts small blind 1200
PhatAction09: posts big blind 2400
*** HOLE CARDS ***
Dealt to phpro [4h 3s]
xxAlHixx: folds
thereaper2u: folds
McLci: folds
oldyellowbricks: folds
phpro: folds
ValeraB96: calls 1200
PhatAction09: checks
*** FLOP *** [Qd Qh Th]
ValeraB96: checks
PhatAction09: checks
*** TURN *** [Qd Qh Th] [Ts]
ValeraB96: checks
PhatAction09: checks
*** RIVER *** [Qd Qh Th Ts] [Jh]
ValeraB96: checks
PhatAction09: checks
*** SHOW DOWN ***
ValeraB96: shows [2h 7c] (two pair, Queens and Tens)
PhatAction09: shows [Kd 2s] (two pair, Queens and Tens - King kicker)
PhatAction09 collected 6900 from pot
*** SUMMARY ***
Total pot 6900 | Rake 0
Board [Qd Qh Th Ts Jh]
Seat 1: xxAlHixx folded before Flop (didn't bet)
Seat 3: thereaper2u folded before Flop (didn't bet)
Seat 4: McLci folded before Flop (didn't bet)
Seat 6: oldyellowbricks folded before Flop (didn't bet)
Seat 7: phpro (button) folded before Flop (didn't bet)
Seat 8: ValeraB96 (small blind) showed [2h 7c] and lost with two pair, Queens and Tens
Seat 9: PhatAction09 (big blind) showed [Kd 2s] and won (6900) with two pair, Queens and Tens


*********** # 221 **************
PokerStars Hand #257047795452: Tournament #3910307458, $0.98+$0.12 USD Hold'em No Limit - Level XXIII (1200/2400) - 2025/07/22 13:25:08 ET
Table '3910307458 19' 9-max Seat #8 is the button
Seat 1: xxAlHixx (29299 in chips)
Seat 3: thereaper2u (75999 in chips)
Seat 4: McLci (80064 in chips)
Seat 6: oldyellowbricks (134219 in chips)
Seat 7: phpro (23079 in chips)
Seat 8: ValeraB96 (42202 in chips)
Seat 9: PhatAction09 (58509 in chips)
xxAlHixx: posts the ante 300
thereaper2u: posts the ante 300
McLci: posts the ante 300
oldyellowbricks: posts the ante 300
phpro: posts the ante 300
ValeraB96: posts the ante 300
PhatAction09: posts the ante 300
PhatAction09: posts small blind 1200
xxAlHixx: posts big blind 2400
*** HOLE CARDS ***
Dealt to phpro [Jd 4c]
thereaper2u: folds
McLci: folds
oldyellowbricks: raises 2400 to 4800
phpro: folds
ValeraB96: raises 37102 to 41902 and is all-in
PhatAction09: folds
xxAlHixx: folds
oldyellowbricks: folds
Uncalled bet (37102) returned to ValeraB96
ValeraB96 collected 15300 from pot
ValeraB96: doesn't show hand
*** SUMMARY ***
Total pot 15300 | Rake 0
Seat 1: xxAlHixx (big blind) folded before Flop
Seat 3: thereaper2u folded before Flop (didn't bet)
Seat 4: McLci folded before Flop (didn't bet)
Seat 6: oldyellowbricks folded before Flop
Seat 7: phpro folded before Flop (didn't bet)
Seat 8: ValeraB96 (button) collected (15300)
Seat 9: PhatAction09 (small blind) folded before Flop


*********** # 222 **************
PokerStars Hand #257047800924: Tournament #3910307458, $0.98+$0.12 USD Hold'em No Limit - Level XXIII (1200/2400) - 2025/07/22 13:25:37 ET
Table '3910307458 19' 9-max Seat #9 is the button
Seat 1: xxAlHixx (26599 in chips)
Seat 3: thereaper2u (75699 in chips)
Seat 4: McLci (79764 in chips)
Seat 6: oldyellowbricks (129119 in chips)
Seat 7: phpro (22779 in chips)
Seat 8: ValeraB96 (52402 in chips)
Seat 9: PhatAction09 (57009 in chips)
xxAlHixx: posts the ante 300
thereaper2u: posts the ante 300
McLci: posts the ante 300
oldyellowbricks: posts the ante 300
phpro: posts the ante 300
ValeraB96: posts the ante 300
PhatAction09: posts the ante 300
xxAlHixx: posts small blind 1200
thereaper2u: posts big blind 2400
*** HOLE CARDS ***
Dealt to phpro [5d Kc]
McLci: folds
oldyellowbricks: folds
phpro: folds
ValeraB96: raises 2400 to 4800
PhatAction09: folds
xxAlHixx: folds
thereaper2u: folds
Uncalled bet (2400) returned to ValeraB96
ValeraB96 collected 8100 from pot
ValeraB96: doesn't show hand
*** SUMMARY ***
Total pot 8100 | Rake 0
Seat 1: xxAlHixx (small blind) folded before Flop
Seat 3: thereaper2u (big blind) folded before Flop
Seat 4: McLci folded before Flop (didn't bet)
Seat 6: oldyellowbricks folded before Flop (didn't bet)
Seat 7: phpro folded before Flop (didn't bet)
Seat 8: ValeraB96 collected (8100)
Seat 9: PhatAction09 (button) folded before Flop (didn't bet)


*********** # 223 **************
PokerStars Hand #257047806477: Tournament #3910307458, $0.98+$0.12 USD Hold'em No Limit - Level XXIII (1200/2400) - 2025/07/22 13:26:07 ET
Table '3910307458 19' 9-max Seat #1 is the button
Seat 1: xxAlHixx (25099 in chips)
Seat 3: thereaper2u (72999 in chips)
Seat 4: McLci (79464 in chips)
Seat 6: oldyellowbricks (128819 in chips)
Seat 7: phpro (22479 in chips)
Seat 8: ValeraB96 (57802 in chips)
Seat 9: PhatAction09 (56709 in chips)
xxAlHixx: posts the ante 300
thereaper2u: posts the ante 300
McLci: posts the ante 300
oldyellowbricks: posts the ante 300
phpro: posts the ante 300
ValeraB96: posts the ante 300
PhatAction09: posts the ante 300
thereaper2u: posts small blind 1200
McLci: posts big blind 2400
*** HOLE CARDS ***
Dealt to phpro [6s 5c]
oldyellowbricks: folds
phpro: folds
ValeraB96: folds
PhatAction09: folds
xxAlHixx: raises 22399 to 24799 and is all-in
thereaper2u: folds
McLci: calls 22399
*** FLOP *** [2c Qc Ad]
*** TURN *** [2c Qc Ad] [Jh]
*** RIVER *** [2c Qc Ad Jh] [Tc]
*** SHOW DOWN ***
McLci: shows [Ts Ac] (two pair, Aces and Tens)
xxAlHixx: shows [9d 9h] (a pair of Nines)
McLci collected 52898 from pot
xxAlHixx finished the tournament in 14th place and received $3.88.
*** SUMMARY ***
Total pot 52898 | Rake 0
Board [2c Qc Ad Jh Tc]
Seat 1: xxAlHixx (button) showed [9d 9h] and lost with a pair of Nines
Seat 3: thereaper2u (small blind) folded before Flop
Seat 4: McLci (big blind) showed [Ts Ac] and won (52898) with two pair, Aces and Tens
Seat 6: oldyellowbricks folded before Flop (didn't bet)
Seat 7: phpro folded before Flop (didn't bet)
Seat 8: ValeraB96 folded before Flop (didn't bet)
Seat 9: PhatAction09 folded before Flop (didn't bet)


*********** # 224 **************
PokerStars Hand #257047814160: Tournament #3910307458, $0.98+$0.12 USD Hold'em No Limit - Level XXIII (1200/2400) - 2025/07/22 13:26:48 ET
Table '3910307458 19' 9-max Seat #3 is the button
Seat 3: thereaper2u (71499 in chips)
Seat 4: McLci (107263 in chips)
Seat 6: oldyellowbricks (128519 in chips)
Seat 7: phpro (22179 in chips)
Seat 8: ValeraB96 (57502 in chips)
Seat 9: PhatAction09 (56409 in chips)
thereaper2u: posts the ante 300
McLci: posts the ante 300
oldyellowbricks: posts the ante 300
phpro: posts the ante 300
ValeraB96: posts the ante 300
PhatAction09: posts the ante 300
McLci: posts small blind 1200
oldyellowbricks: posts big blind 2400
*** HOLE CARDS ***
Dealt to phpro [Kh 2d]
phpro: folds
ValeraB96: folds
PhatAction09: raises 3000 to 5400
thereaper2u: folds
McLci: folds
oldyellowbricks: calls 3000
*** FLOP *** [8s Th 9s]
oldyellowbricks: checks
PhatAction09: bets 7200
oldyellowbricks: calls 7200
*** TURN *** [8s Th 9s] [Tc]
oldyellowbricks: checks
PhatAction09: bets 9600
oldyellowbricks: calls 9600
*** RIVER *** [8s Th 9s Tc] [2s]
oldyellowbricks: checks
PhatAction09: bets 33909 and is all-in
oldyellowbricks: folds
Uncalled bet (33909) returned to PhatAction09
PhatAction09 collected 47400 from pot
PhatAction09: doesn't show hand
*** SUMMARY ***
Total pot 47400 | Rake 0
Board [8s Th 9s Tc 2s]
Seat 3: thereaper2u (button) folded before Flop (didn't bet)
Seat 4: McLci (small blind) folded before Flop
Seat 6: oldyellowbricks (big blind) folded on the River
Seat 7: phpro folded before Flop (didn't bet)
Seat 8: ValeraB96 folded before Flop (didn't bet)
Seat 9: PhatAction09 collected (47400)


*********** # 225 **************
PokerStars Hand #257047827985: Tournament #3910307458, $0.98+$0.12 USD Hold'em No Limit - Level XXIII (1200/2400) - 2025/07/22 13:28:01 ET
Table '3910307458 19' 9-max Seat #4 is the button
Seat 3: thereaper2u (71199 in chips)
Seat 4: McLci (105763 in chips)
Seat 6: oldyellowbricks (106019 in chips)
Seat 7: phpro (21879 in chips)
Seat 8: ValeraB96 (57202 in chips)
Seat 9: PhatAction09 (81309 in chips)
thereaper2u: posts the ante 300
McLci: posts the ante 300
oldyellowbricks: posts the ante 300
phpro: posts the ante 300
ValeraB96: posts the ante 300
PhatAction09: posts the ante 300
oldyellowbricks: posts small blind 1200
phpro: posts big blind 2400
*** HOLE CARDS ***
Dealt to phpro [6c Kh]
ValeraB96: folds
PhatAction09: folds
thereaper2u: folds
McLci: raises 2400 to 4800
oldyellowbricks: folds
phpro: folds
Uncalled bet (2400) returned to McLci
McLci collected 7800 from pot
McLci: doesn't show hand
*** SUMMARY ***
Total pot 7800 | Rake 0
Seat 3: thereaper2u folded before Flop (didn't bet)
Seat 4: McLci (button) collected (7800)
Seat 6: oldyellowbricks (small blind) folded before Flop
Seat 7: phpro (big blind) folded before Flop
Seat 8: ValeraB96 folded before Flop (didn't bet)
Seat 9: PhatAction09 folded before Flop (didn't bet)


*********** # 226 **************
PokerStars Hand #257047833576: Tournament #3910307458, $0.98+$0.12 USD Hold'em No Limit - Level XXIII (1200/2400) - 2025/07/22 13:28:31 ET
Table '3910307458 19' 9-max Seat #6 is the button
Seat 3: thereaper2u (70899 in chips)
Seat 4: McLci (110863 in chips)
Seat 6: oldyellowbricks (104519 in chips)
Seat 7: phpro (19179 in chips)
Seat 8: ValeraB96 (56902 in chips)
Seat 9: PhatAction09 (81009 in chips)
thereaper2u: posts the ante 300
McLci: posts the ante 300
oldyellowbricks: posts the ante 300
phpro: posts the ante 300
ValeraB96: posts the ante 300
PhatAction09: posts the ante 300
phpro: posts small blind 1200
ValeraB96: posts big blind 2400
*** HOLE CARDS ***
Dealt to phpro [3d Th]
PhatAction09: folds
thereaper2u: folds
McLci: folds
oldyellowbricks: folds
phpro: raises 16479 to 18879 and is all-in
ValeraB96: folds
Uncalled bet (16479) returned to phpro
phpro collected 6600 from pot
phpro: doesn't show hand
*** SUMMARY ***
Total pot 6600 | Rake 0
Seat 3: thereaper2u folded before Flop (didn't bet)
Seat 4: McLci folded before Flop (didn't bet)
Seat 6: oldyellowbricks (button) folded before Flop (didn't bet)
Seat 7: phpro (small blind) collected (6600)
Seat 8: ValeraB96 (big blind) folded before Flop
Seat 9: PhatAction09 folded before Flop (didn't bet)


*********** # 227 **************
PokerStars Hand #257047837340: Tournament #3910307458, $0.98+$0.12 USD Hold'em No Limit - Level XXIII (1200/2400) - 2025/07/22 13:28:51 ET
Table '3910307458 19' 9-max Seat #7 is the button
Seat 3: thereaper2u (70599 in chips)
Seat 4: McLci (110563 in chips)
Seat 6: oldyellowbricks (104219 in chips)
Seat 7: phpro (23079 in chips)
Seat 8: ValeraB96 (54202 in chips)
Seat 9: PhatAction09 (80709 in chips)
thereaper2u: posts the ante 300
McLci: posts the ante 300
oldyellowbricks: posts the ante 300
phpro: posts the ante 300
ValeraB96: posts the ante 300
PhatAction09: posts the ante 300
ValeraB96: posts small blind 1200
PhatAction09: posts big blind 2400
*** HOLE CARDS ***
Dealt to phpro [Qd 3s]
thereaper2u: folds
McLci: folds
oldyellowbricks: raises 2400 to 4800
phpro: folds
ValeraB96: folds
PhatAction09: folds
Uncalled bet (2400) returned to oldyellowbricks
oldyellowbricks collected 7800 from pot
oldyellowbricks: doesn't show hand
*** SUMMARY ***
Total pot 7800 | Rake 0
Seat 3: thereaper2u folded before Flop (didn't bet)
Seat 4: McLci folded before Flop (didn't bet)
Seat 6: oldyellowbricks collected (7800)
Seat 7: phpro (button) folded before Flop (didn't bet)
Seat 8: ValeraB96 (small blind) folded before Flop
Seat 9: PhatAction09 (big blind) folded before Flop


*********** # 228 **************
PokerStars Hand #257047841132: Tournament #3910307458, $0.98+$0.12 USD Hold'em No Limit - Level XXIII (1200/2400) - 2025/07/22 13:29:12 ET
Table '3910307458 19' 9-max Seat #8 is the button
Seat 3: thereaper2u (70299 in chips)
Seat 4: McLci (110263 in chips)
Seat 6: oldyellowbricks (109319 in chips)
Seat 7: phpro (22779 in chips)
Seat 8: ValeraB96 (52702 in chips)
Seat 9: PhatAction09 (78009 in chips)
thereaper2u: posts the ante 300
McLci: posts the ante 300
oldyellowbricks: posts the ante 300
phpro: posts the ante 300
ValeraB96: posts the ante 300
PhatAction09: posts the ante 300
PhatAction09: posts small blind 1200
thereaper2u: posts big blind 2400
*** HOLE CARDS ***
Dealt to phpro [6s 4h]
McLci: folds
oldyellowbricks: raises 2400 to 4800
phpro: folds
ValeraB96: folds
PhatAction09: raises 72909 to 77709 and is all-in
thereaper2u: folds
oldyellowbricks: folds
Uncalled bet (72909) returned to PhatAction09
PhatAction09 collected 13800 from pot
PhatAction09: doesn't show hand
*** SUMMARY ***
Total pot 13800 | Rake 0
Seat 3: thereaper2u (big blind) folded before Flop
Seat 4: McLci folded before Flop (didn't bet)
Seat 6: oldyellowbricks folded before Flop
Seat 7: phpro folded before Flop (didn't bet)
Seat 8: ValeraB96 (button) folded before Flop (didn't bet)
Seat 9: PhatAction09 (small blind) collected (13800)


*********** # 229 **************
PokerStars Hand #257047848636: Tournament #3910307458, $0.98+$0.12 USD Hold'em No Limit - Level XXIV (1400/2800) - 2025/07/22 13:29:52 ET
Table '3910307458 19' 9-max Seat #9 is the button
Seat 3: thereaper2u (67599 in chips)
Seat 4: McLci (109963 in chips)
Seat 6: oldyellowbricks (104219 in chips)
Seat 7: phpro (22479 in chips)
Seat 8: ValeraB96 (52402 in chips)
Seat 9: PhatAction09 (86709 in chips)
thereaper2u: posts the ante 350
McLci: posts the ante 350
oldyellowbricks: posts the ante 350
phpro: posts the ante 350
ValeraB96: posts the ante 350
PhatAction09: posts the ante 350
thereaper2u: posts small blind 1400
McLci: posts big blind 2800
*** HOLE CARDS ***
Dealt to phpro [2h 7s]
oldyellowbricks: folds
phpro: folds
ValeraB96: raises 2800 to 5600
PhatAction09: folds
thereaper2u: folds
McLci: calls 2800
*** FLOP *** [4d 6c Kc]
McLci: checks
ValeraB96: bets 4424
McLci: folds
Uncalled bet (4424) returned to ValeraB96
ValeraB96 collected 14700 from pot
ValeraB96: doesn't show hand
*** SUMMARY ***
Total pot 14700 | Rake 0
Board [4d 6c Kc]
Seat 3: thereaper2u (small blind) folded before Flop
Seat 4: McLci (big blind) folded on the Flop
Seat 6: oldyellowbricks folded before Flop (didn't bet)
Seat 7: phpro folded before Flop (didn't bet)
Seat 8: ValeraB96 collected (14700)
Seat 9: PhatAction09 (button) folded before Flop (didn't bet)


*********** # 230 **************
PokerStars Hand #257047856939: Tournament #3910307458, $0.98+$0.12 USD Hold'em No Limit - Level XXIV (1400/2800) - 2025/07/22 13:30:34 ET
Table '3910307458 19' 9-max Seat #3 is the button
Seat 3: thereaper2u (65849 in chips)
Seat 4: McLci (104013 in chips)
Seat 6: oldyellowbricks (103869 in chips)
Seat 7: phpro (22129 in chips)
Seat 8: ValeraB96 (61152 in chips)
Seat 9: PhatAction09 (86359 in chips)
thereaper2u: posts the ante 350
McLci: posts the ante 350
oldyellowbricks: posts the ante 350
phpro: posts the ante 350
ValeraB96: posts the ante 350
PhatAction09: posts the ante 350
McLci: posts small blind 1400
oldyellowbricks: posts big blind 2800
*** HOLE CARDS ***
Dealt to phpro [Tc 2c]
phpro: folds
ValeraB96: folds
PhatAction09: folds
thereaper2u: folds
McLci: folds
Uncalled bet (1400) returned to oldyellowbricks
oldyellowbricks collected 4900 from pot
oldyellowbricks: doesn't show hand
*** SUMMARY ***
Total pot 4900 | Rake 0
Seat 3: thereaper2u (button) folded before Flop (didn't bet)
Seat 4: McLci (small blind) folded before Flop
Seat 6: oldyellowbricks (big blind) collected (4900)
Seat 7: phpro folded before Flop (didn't bet)
Seat 8: ValeraB96 folded before Flop (didn't bet)
Seat 9: PhatAction09 folded before Flop (didn't bet)


*********** # 231 **************
PokerStars Hand #257047859326: Tournament #3910307458, $0.98+$0.12 USD Hold'em No Limit - Level XXIV (1400/2800) - 2025/07/22 13:30:47 ET
Table '3910307458 19' 9-max Seat #4 is the button
Seat 3: thereaper2u (65499 in chips)
Seat 4: McLci (102263 in chips)
Seat 6: oldyellowbricks (107019 in chips)
Seat 7: phpro (21779 in chips)
Seat 8: ValeraB96 (60802 in chips)
Seat 9: PhatAction09 (86009 in chips)
thereaper2u: posts the ante 350
McLci: posts the ante 350
oldyellowbricks: posts the ante 350
phpro: posts the ante 350
ValeraB96: posts the ante 350
PhatAction09: posts the ante 350
oldyellowbricks: posts small blind 1400
phpro: posts big blind 2800
*** HOLE CARDS ***
Dealt to phpro [Ad 2c]
ValeraB96: folds
PhatAction09: folds
thereaper2u: folds
McLci: folds
oldyellowbricks: raises 19600 to 22400
phpro: folds
Uncalled bet (19600) returned to oldyellowbricks
oldyellowbricks collected 7700 from pot
oldyellowbricks: doesn't show hand
*** SUMMARY ***
Total pot 7700 | Rake 0
Seat 3: thereaper2u folded before Flop (didn't bet)
Seat 4: McLci (button) folded before Flop (didn't bet)
Seat 6: oldyellowbricks (small blind) collected (7700)
Seat 7: phpro (big blind) folded before Flop
Seat 8: ValeraB96 folded before Flop (didn't bet)
Seat 9: PhatAction09 folded before Flop (didn't bet)


*********** # 232 **************
PokerStars Hand #257047865355: Tournament #3910307458, $0.98+$0.12 USD Hold'em No Limit - Level XXIV (1400/2800) - 2025/07/22 13:31:18 ET
Table '3910307458 19' 9-max Seat #6 is the button
Seat 3: thereaper2u (65149 in chips)
Seat 4: McLci (101913 in chips)
Seat 6: oldyellowbricks (111569 in chips)
Seat 7: phpro (18629 in chips)
Seat 8: ValeraB96 (60452 in chips)
Seat 9: PhatAction09 (85659 in chips)
thereaper2u: posts the ante 350
McLci: posts the ante 350
oldyellowbricks: posts the ante 350
phpro: posts the ante 350
ValeraB96: posts the ante 350
PhatAction09: posts the ante 350
phpro: posts small blind 1400
ValeraB96: posts big blind 2800
*** HOLE CARDS ***
Dealt to phpro [8d 7c]
PhatAction09: folds
thereaper2u: folds
McLci: folds
oldyellowbricks: raises 2800 to 5600
phpro: folds
ValeraB96: raises 54502 to 60102 and is all-in
oldyellowbricks: folds
Uncalled bet (54502) returned to ValeraB96
ValeraB96 collected 14700 from pot
ValeraB96: doesn't show hand
*** SUMMARY ***
Total pot 14700 | Rake 0
Seat 3: thereaper2u folded before Flop (didn't bet)
Seat 4: McLci folded before Flop (didn't bet)
Seat 6: oldyellowbricks (button) folded before Flop
Seat 7: phpro (small blind) folded before Flop
Seat 8: ValeraB96 (big blind) collected (14700)
Seat 9: PhatAction09 folded before Flop (didn't bet)


*********** # 233 **************
PokerStars Hand #257047869208: Tournament #3910307458, $0.98+$0.12 USD Hold'em No Limit - Level XXIV (1400/2800) - 2025/07/22 13:31:38 ET
Table '3910307458 19' 9-max Seat #7 is the button
Seat 3: thereaper2u (64799 in chips)
Seat 4: McLci (101563 in chips)
Seat 6: oldyellowbricks (105619 in chips)
Seat 7: phpro (16879 in chips)
Seat 8: ValeraB96 (69202 in chips)
Seat 9: PhatAction09 (85309 in chips)
thereaper2u: posts the ante 350
McLci: posts the ante 350
oldyellowbricks: posts the ante 350
phpro: posts the ante 350
ValeraB96: posts the ante 350
PhatAction09: posts the ante 350
ValeraB96: posts small blind 1400
PhatAction09: posts big blind 2800
*** HOLE CARDS ***
Dealt to phpro [Tc Jh]
thereaper2u: folds
McLci: raises 2800 to 5600
oldyellowbricks: folds
phpro: folds
ValeraB96: folds
PhatAction09: folds
Uncalled bet (2800) returned to McLci
McLci collected 9100 from pot
McLci: doesn't show hand
*** SUMMARY ***
Total pot 9100 | Rake 0
Seat 3: thereaper2u folded before Flop (didn't bet)
Seat 4: McLci collected (9100)
Seat 6: oldyellowbricks folded before Flop (didn't bet)
Seat 7: phpro (button) folded before Flop (didn't bet)
Seat 8: ValeraB96 (small blind) folded before Flop
Seat 9: PhatAction09 (big blind) folded before Flop


*********** # 234 **************
PokerStars Hand #257047872967: Tournament #3910307458, $0.98+$0.12 USD Hold'em No Limit - Level XXIV (1400/2800) - 2025/07/22 13:31:57 ET
Table '3910307458 19' 9-max Seat #8 is the button
Seat 3: thereaper2u (64449 in chips)
Seat 4: McLci (107513 in chips)
Seat 6: oldyellowbricks (105269 in chips)
Seat 7: phpro (16529 in chips)
Seat 8: ValeraB96 (67452 in chips)
Seat 9: PhatAction09 (82159 in chips)
thereaper2u: posts the ante 350
McLci: posts the ante 350
oldyellowbricks: posts the ante 350
phpro: posts the ante 350
ValeraB96: posts the ante 350
PhatAction09: posts the ante 350
PhatAction09: posts small blind 1400
thereaper2u: posts big blind 2800
*** HOLE CARDS ***
Dealt to phpro [Qc Jh]
McLci: folds
oldyellowbricks: folds
phpro: raises 2800 to 5600
ValeraB96: folds
PhatAction09: folds
thereaper2u: calls 2800
*** FLOP *** [7c Ad 4d]
thereaper2u: checks
phpro: bets 10579 and is all-in
thereaper2u: folds
Uncalled bet (10579) returned to phpro
phpro collected 14700 from pot
phpro: doesn't show hand
*** SUMMARY ***
Total pot 14700 | Rake 0
Board [7c Ad 4d]
Seat 3: thereaper2u (big blind) folded on the Flop
Seat 4: McLci folded before Flop (didn't bet)
Seat 6: oldyellowbricks folded before Flop (didn't bet)
Seat 7: phpro collected (14700)
Seat 8: ValeraB96 (button) folded before Flop (didn't bet)
Seat 9: PhatAction09 (small blind) folded before Flop


*********** # 235 **************
PokerStars Hand #257047879077: Tournament #3910307458, $0.98+$0.12 USD Hold'em No Limit - Level XXIV (1400/2800) - 2025/07/22 13:32:29 ET
Table '3910307458 19' 9-max Seat #9 is the button
Seat 3: thereaper2u (58499 in chips)
Seat 4: McLci (107163 in chips)
Seat 6: oldyellowbricks (104919 in chips)
Seat 7: phpro (25279 in chips)
Seat 8: ValeraB96 (67102 in chips)
Seat 9: PhatAction09 (80409 in chips)
thereaper2u: posts the ante 350
McLci: posts the ante 350
oldyellowbricks: posts the ante 350
phpro: posts the ante 350
ValeraB96: posts the ante 350
PhatAction09: posts the ante 350
thereaper2u: posts small blind 1400
McLci: posts big blind 2800
*** HOLE CARDS ***
Dealt to phpro [Js Kh]
oldyellowbricks: folds
phpro: raises 22129 to 24929 and is all-in
ValeraB96: folds
PhatAction09: folds
thereaper2u: folds
McLci: folds
Uncalled bet (22129) returned to phpro
phpro collected 9100 from pot
phpro: doesn't show hand
*** SUMMARY ***
Total pot 9100 | Rake 0
Seat 3: thereaper2u (small blind) folded before Flop
Seat 4: McLci (big blind) folded before Flop
Seat 6: oldyellowbricks folded before Flop (didn't bet)
Seat 7: phpro collected (9100)
Seat 8: ValeraB96 folded before Flop (didn't bet)
Seat 9: PhatAction09 (button) folded before Flop (didn't bet)


*********** # 236 **************
PokerStars Hand #257047882120: Tournament #3910307458, $0.98+$0.12 USD Hold'em No Limit - Level XXIV (1400/2800) - 2025/07/22 13:32:45 ET
Table '3910307458 19' 9-max Seat #3 is the button
Seat 3: thereaper2u (56749 in chips)
Seat 4: McLci (104013 in chips)
Seat 6: oldyellowbricks (104569 in chips)
Seat 7: phpro (31229 in chips)
Seat 8: ValeraB96 (66752 in chips)
Seat 9: PhatAction09 (80059 in chips)
thereaper2u: posts the ante 350
McLci: posts the ante 350
oldyellowbricks: posts the ante 350
phpro: posts the ante 350
ValeraB96: posts the ante 350
PhatAction09: posts the ante 350
McLci: posts small blind 1400
oldyellowbricks: posts big blind 2800
*** HOLE CARDS ***
Dealt to phpro [Js 9s]
phpro: folds
ValeraB96: folds
PhatAction09: raises 3500 to 6300
thereaper2u: folds
McLci: folds
oldyellowbricks: calls 3500
*** FLOP *** [3s 7s Qd]
oldyellowbricks: checks
PhatAction09: checks
*** TURN *** [3s 7s Qd] [4h]
oldyellowbricks: bets 11200
PhatAction09: folds
Uncalled bet (11200) returned to oldyellowbricks
oldyellowbricks collected 16100 from pot
oldyellowbricks: doesn't show hand
*** SUMMARY ***
Total pot 16100 | Rake 0
Board [3s 7s Qd 4h]
Seat 3: thereaper2u (button) folded before Flop (didn't bet)
Seat 4: McLci (small blind) folded before Flop
Seat 6: oldyellowbricks (big blind) collected (16100)
Seat 7: phpro folded before Flop (didn't bet)
Seat 8: ValeraB96 folded before Flop (didn't bet)
Seat 9: PhatAction09 folded on the Turn


*********** # 237 **************
PokerStars Hand #257047892012: Tournament #3910307458, $0.98+$0.12 USD Hold'em No Limit - Level XXIV (1400/2800) - 2025/07/22 13:33:36 ET
Table '3910307458 19' 9-max Seat #4 is the button
Seat 3: thereaper2u (56399 in chips)
Seat 4: McLci (102263 in chips)
Seat 6: oldyellowbricks (114019 in chips)
Seat 7: phpro (30879 in chips)
Seat 8: ValeraB96 (66402 in chips)
Seat 9: PhatAction09 (73409 in chips)
thereaper2u: posts the ante 350
McLci: posts the ante 350
oldyellowbricks: posts the ante 350
phpro: posts the ante 350
ValeraB96: posts the ante 350
PhatAction09: posts the ante 350
oldyellowbricks: posts small blind 1400
phpro: posts big blind 2800
*** HOLE CARDS ***
Dealt to phpro [6h 7s]
ValeraB96: folds
PhatAction09: folds
thereaper2u: raises 9100 to 11900
McLci: folds
oldyellowbricks: folds
phpro: folds
Uncalled bet (9100) returned to thereaper2u
thereaper2u collected 9100 from pot
thereaper2u: doesn't show hand
*** SUMMARY ***
Total pot 9100 | Rake 0
Seat 3: thereaper2u collected (9100)
Seat 4: McLci (button) folded before Flop (didn't bet)
Seat 6: oldyellowbricks (small blind) folded before Flop
Seat 7: phpro (big blind) folded before Flop
Seat 8: ValeraB96 folded before Flop (didn't bet)
Seat 9: PhatAction09 folded before Flop (didn't bet)


*********** # 238 **************
PokerStars Hand #257047895653: Tournament #3910307458, $0.98+$0.12 USD Hold'em No Limit - Level XXIV (1400/2800) - 2025/07/22 13:33:55 ET
Table '3910307458 19' 9-max Seat #6 is the button
Seat 3: thereaper2u (62349 in chips)
Seat 4: McLci (101913 in chips)
Seat 6: oldyellowbricks (112269 in chips)
Seat 7: phpro (27729 in chips)
Seat 8: ValeraB96 (66052 in chips)
Seat 9: PhatAction09 (73059 in chips)
thereaper2u: posts the ante 350
McLci: posts the ante 350
oldyellowbricks: posts the ante 350
phpro: posts the ante 350
ValeraB96: posts the ante 350
PhatAction09: posts the ante 350
phpro: posts small blind 1400
ValeraB96: posts big blind 2800
*** HOLE CARDS ***
Dealt to phpro [9h Kd]
PhatAction09: folds
thereaper2u: folds
McLci: raises 2800 to 5600
oldyellowbricks: folds
phpro: folds
ValeraB96: folds
Uncalled bet (2800) returned to McLci
McLci collected 9100 from pot
McLci: doesn't show hand
*** SUMMARY ***
Total pot 9100 | Rake 0
Seat 3: thereaper2u folded before Flop (didn't bet)
Seat 4: McLci collected (9100)
Seat 6: oldyellowbricks (button) folded before Flop (didn't bet)
Seat 7: phpro (small blind) folded before Flop
Seat 8: ValeraB96 (big blind) folded before Flop
Seat 9: PhatAction09 folded before Flop (didn't bet)


*********** # 239 **************
PokerStars Hand #257047900400: Tournament #3910307458, $0.98+$0.12 USD Hold'em No Limit - Level XXIV (1400/2800) - 2025/07/22 13:34:20 ET
Table '3910307458 19' 9-max Seat #7 is the button
Seat 3: thereaper2u (61999 in chips)
Seat 4: McLci (107863 in chips)
Seat 6: oldyellowbricks (111919 in chips)
Seat 7: phpro (25979 in chips)
Seat 8: ValeraB96 (62902 in chips)
Seat 9: PhatAction09 (72709 in chips)
thereaper2u: posts the ante 350
McLci: posts the ante 350
oldyellowbricks: posts the ante 350
phpro: posts the ante 350
ValeraB96: posts the ante 350
PhatAction09: posts the ante 350
ValeraB96: posts small blind 1400
PhatAction09: posts big blind 2800
*** HOLE CARDS ***
Dealt to phpro [Qs 5d]
thereaper2u: folds
McLci: raises 2800 to 5600
oldyellowbricks: folds
phpro: folds
ValeraB96: folds
PhatAction09: folds
Uncalled bet (2800) returned to McLci
McLci collected 9100 from pot
McLci: doesn't show hand
*** SUMMARY ***
Total pot 9100 | Rake 0
Seat 3: thereaper2u folded before Flop (didn't bet)
Seat 4: McLci collected (9100)
Seat 6: oldyellowbricks folded before Flop (didn't bet)
Seat 7: phpro (button) folded before Flop (didn't bet)
Seat 8: ValeraB96 (small blind) folded before Flop
Seat 9: PhatAction09 (big blind) folded before Flop


*********** # 240 **************
PokerStars Hand #257047904636: Tournament #3910307458, $0.98+$0.12 USD Hold'em No Limit - Level XXIV (1400/2800) - 2025/07/22 13:34:43 ET
Table '3910307458 19' 9-max Seat #8 is the button
Seat 3: thereaper2u (61649 in chips)
Seat 4: McLci (113813 in chips)
Seat 6: oldyellowbricks (111569 in chips)
Seat 7: phpro (25629 in chips)
Seat 8: ValeraB96 (61152 in chips)
Seat 9: PhatAction09 (69559 in chips)
thereaper2u: posts the ante 350
McLci: posts the ante 350
oldyellowbricks: posts the ante 350
phpro: posts the ante 350
ValeraB96: posts the ante 350
PhatAction09: posts the ante 350
PhatAction09: posts small blind 1400
thereaper2u: posts big blind 2800
*** HOLE CARDS ***
Dealt to phpro [2s 9s]
McLci: folds
oldyellowbricks: folds
phpro: folds
ValeraB96: raises 2800 to 5600
PhatAction09: raises 63609 to 69209 and is all-in
thereaper2u: folds
ValeraB96: calls 55202 and is all-in
Uncalled bet (8407) returned to PhatAction09
*** FLOP *** [4c 7s 3h]
*** TURN *** [4c 7s 3h] [4s]
*** RIVER *** [4c 7s 3h 4s] [Td]
*** SHOW DOWN ***
PhatAction09: shows [Qc Kc] (a pair of Fours)
ValeraB96: shows [Ac Qd] (a pair of Fours - Ace kicker)
ValeraB96 collected 126504 from pot
*** SUMMARY ***
Total pot 126504 | Rake 0
Board [4c 7s 3h 4s Td]
Seat 3: thereaper2u (big blind) folded before Flop
Seat 4: McLci folded before Flop (didn't bet)
Seat 6: oldyellowbricks folded before Flop (didn't bet)
Seat 7: phpro folded before Flop (didn't bet)
Seat 8: ValeraB96 (button) showed [Ac Qd] and won (126504) with a pair of Fours
Seat 9: PhatAction09 (small blind) showed [Qc Kc] and lost with a pair of Fours


*********** # 241 **************
PokerStars Hand #257047911262: Tournament #3910307458, $0.98+$0.12 USD Hold'em No Limit - Level XXIV (1400/2800) - 2025/07/22 13:35:17 ET
Table '3910307458 19' 9-max Seat #9 is the button
Seat 3: thereaper2u (58499 in chips)
Seat 4: McLci (113463 in chips)
Seat 6: oldyellowbricks (111219 in chips)
Seat 7: phpro (25279 in chips)
Seat 8: ValeraB96 (126504 in chips)
Seat 9: PhatAction09 (8407 in chips)
thereaper2u: posts the ante 350
McLci: posts the ante 350
oldyellowbricks: posts the ante 350
phpro: posts the ante 350
ValeraB96: posts the ante 350
PhatAction09: posts the ante 350
thereaper2u: posts small blind 1400
McLci: posts big blind 2800
*** HOLE CARDS ***
Dealt to phpro [4c 2s]
oldyellowbricks: raises 2800 to 5600
phpro: folds
ValeraB96: folds
PhatAction09: raises 2457 to 8057 and is all-in
thereaper2u: folds
McLci: folds
oldyellowbricks: calls 2457
*** FLOP *** [3c 7d Ac]
*** TURN *** [3c 7d Ac] [2c]
*** RIVER *** [3c 7d Ac 2c] [As]
*** SHOW DOWN ***
oldyellowbricks: shows [Ad Kh] (three of a kind, Aces)
PhatAction09: shows [Ts Qh] (a pair of Aces)
oldyellowbricks collected 22414 from pot
PhatAction09 finished the tournament in 12th place and received $5.04.
*** SUMMARY ***
Total pot 22414 | Rake 0
Board [3c 7d Ac 2c As]
Seat 3: thereaper2u (small blind) folded before Flop
Seat 4: McLci (big blind) folded before Flop
Seat 6: oldyellowbricks showed [Ad Kh] and won (22414) with three of a kind, Aces
Seat 7: phpro folded before Flop (didn't bet)
Seat 8: ValeraB96 folded before Flop (didn't bet)
Seat 9: PhatAction09 (button) showed [Ts Qh] and lost with a pair of Aces


*********** # 242 **************
PokerStars Hand #257047916864: Tournament #3910307458, $0.98+$0.12 USD Hold'em No Limit - Level XXIV (1400/2800) - 2025/07/22 13:35:46 ET
Table '3910307458 19' 9-max Seat #3 is the button
Seat 3: thereaper2u (56749 in chips)
Seat 4: McLci (110313 in chips)
Seat 6: oldyellowbricks (125226 in chips)
Seat 7: phpro (24929 in chips)
Seat 8: ValeraB96 (126154 in chips)
thereaper2u: posts the ante 350
McLci: posts the ante 350
oldyellowbricks: posts the ante 350
phpro: posts the ante 350
ValeraB96: posts the ante 350
McLci: posts small blind 1400
oldyellowbricks: posts big blind 2800
*** HOLE CARDS ***
Dealt to phpro [Jh 3h]
phpro: folds
ValeraB96: raises 2800 to 5600
thereaper2u: folds
McLci: folds
oldyellowbricks: raises 16800 to 22400
ValeraB96: folds
Uncalled bet (16800) returned to oldyellowbricks
oldyellowbricks collected 14350 from pot
oldyellowbricks: doesn't show hand
*** SUMMARY ***
Total pot 14350 | Rake 0
Seat 3: thereaper2u (button) folded before Flop (didn't bet)
Seat 4: McLci (small blind) folded before Flop
Seat 6: oldyellowbricks (big blind) collected (14350)
Seat 7: phpro folded before Flop (didn't bet)
Seat 8: ValeraB96 folded before Flop


*********** # 243 **************
PokerStars Hand #257047920353: Tournament #3910307458, $0.98+$0.12 USD Hold'em No Limit - Level XXIV (1400/2800) - 2025/07/22 13:36:05 ET
Table '3910307458 19' 9-max Seat #4 is the button
Seat 3: thereaper2u (56399 in chips)
Seat 4: McLci (108563 in chips)
Seat 6: oldyellowbricks (133626 in chips)
Seat 7: phpro (24579 in chips)
Seat 8: ValeraB96 (120204 in chips)
thereaper2u: posts the ante 350
McLci: posts the ante 350
oldyellowbricks: posts the ante 350
phpro: posts the ante 350
ValeraB96: posts the ante 350
oldyellowbricks: posts small blind 1400
phpro: posts big blind 2800
*** HOLE CARDS ***
Dealt to phpro [6s 4c]
ValeraB96: folds
thereaper2u: folds
McLci: raises 2800 to 5600
oldyellowbricks: folds
phpro: folds
Uncalled bet (2800) returned to McLci
McLci collected 8750 from pot
McLci: doesn't show hand
*** SUMMARY ***
Total pot 8750 | Rake 0
Seat 3: thereaper2u folded before Flop (didn't bet)
Seat 4: McLci (button) collected (8750)
Seat 6: oldyellowbricks (small blind) folded before Flop
Seat 7: phpro (big blind) folded before Flop
Seat 8: ValeraB96 folded before Flop (didn't bet)


*********** # 244 **************
PokerStars Hand #257047923039: Tournament #3910307458, $0.98+$0.12 USD Hold'em No Limit - Level XXIV (1400/2800) - 2025/07/22 13:36:19 ET
Table '3910307458 19' 9-max Seat #6 is the button
Seat 3: thereaper2u (56049 in chips)
Seat 4: McLci (114163 in chips)
Seat 6: oldyellowbricks (131876 in chips)
Seat 7: phpro (21429 in chips)
Seat 8: ValeraB96 (119854 in chips)
thereaper2u: posts the ante 350
McLci: posts the ante 350
oldyellowbricks: posts the ante 350
phpro: posts the ante 350
ValeraB96: posts the ante 350
phpro: posts small blind 1400
ValeraB96: posts big blind 2800
*** HOLE CARDS ***
Dealt to phpro [Js 3s]
thereaper2u: folds
McLci: raises 2800 to 5600
oldyellowbricks: folds
phpro: folds
ValeraB96: folds
Uncalled bet (2800) returned to McLci
McLci collected 8750 from pot
McLci: doesn't show hand
*** SUMMARY ***
Total pot 8750 | Rake 0
Seat 3: thereaper2u folded before Flop (didn't bet)
Seat 4: McLci collected (8750)
Seat 6: oldyellowbricks (button) folded before Flop (didn't bet)
Seat 7: phpro (small blind) folded before Flop
Seat 8: ValeraB96 (big blind) folded before Flop


*********** # 245 **************
PokerStars Hand #257047926007: Tournament #3910307458, $0.98+$0.12 USD Hold'em No Limit - Level XXIV (1400/2800) - 2025/07/22 13:36:34 ET
Table '3910307458 19' 9-max Seat #7 is the button
Seat 3: thereaper2u (55699 in chips)
Seat 4: McLci (119763 in chips)
Seat 6: oldyellowbricks (131526 in chips)
Seat 7: phpro (19679 in chips)
Seat 8: ValeraB96 (116704 in chips)
thereaper2u: posts the ante 350
McLci: posts the ante 350
oldyellowbricks: posts the ante 350
phpro: posts the ante 350
ValeraB96: posts the ante 350
ValeraB96: posts small blind 1400
thereaper2u: posts big blind 2800
*** HOLE CARDS ***
Dealt to phpro [4s Jd]
McLci: raises 8400 to 11200
oldyellowbricks: raises 8400 to 19600
phpro: folds
ValeraB96: folds
thereaper2u: folds
McLci: calls 8400
*** FLOP *** [6h Ad Qc]
McLci: checks
oldyellowbricks: checks
*** TURN *** [6h Ad Qc] [6d]
McLci: checks
oldyellowbricks: bets 14900
McLci: folds
Uncalled bet (14900) returned to oldyellowbricks
oldyellowbricks collected 45150 from pot
oldyellowbricks: doesn't show hand
*** SUMMARY ***
Total pot 45150 | Rake 0
Board [6h Ad Qc 6d]
Seat 3: thereaper2u (big blind) folded before Flop
Seat 4: McLci folded on the Turn
Seat 6: oldyellowbricks collected (45150)
Seat 7: phpro (button) folded before Flop (didn't bet)
Seat 8: ValeraB96 (small blind) folded before Flop


*********** # 246 **************
PokerStars Hand #257047936873: Tournament #3910307458, $0.98+$0.12 USD Hold'em No Limit - Level XXIV (1400/2800) - 2025/07/22 13:37:30 ET
Table '3910307458 19' 9-max Seat #8 is the button
Seat 3: thereaper2u (52549 in chips)
Seat 4: McLci (99813 in chips)
Seat 6: oldyellowbricks (156726 in chips)
Seat 7: phpro (19329 in chips)
Seat 8: ValeraB96 (114954 in chips)
thereaper2u: posts the ante 350
McLci: posts the ante 350
oldyellowbricks: posts the ante 350
phpro: posts the ante 350
ValeraB96: posts the ante 350
thereaper2u: posts small blind 1400
McLci: posts big blind 2800
*** HOLE CARDS ***
Dealt to phpro [Th Jh]
oldyellowbricks: folds
phpro: raises 16179 to 18979 and is all-in
ValeraB96: folds
thereaper2u: folds
McLci: folds
Uncalled bet (16179) returned to phpro
phpro collected 8750 from pot
phpro: doesn't show hand
*** SUMMARY ***
Total pot 8750 | Rake 0
Seat 3: thereaper2u (small blind) folded before Flop
Seat 4: McLci (big blind) folded before Flop
Seat 6: oldyellowbricks folded before Flop (didn't bet)
Seat 7: phpro collected (8750)
Seat 8: ValeraB96 (button) folded before Flop (didn't bet)


*********** # 247 **************
PokerStars Hand #257047941807: Tournament #3910307458, $0.98+$0.12 USD Hold'em No Limit - Level XXIV (1400/2800) - 2025/07/22 13:37:56 ET
Table '3910307458 19' 9-max Seat #3 is the button
Seat 3: thereaper2u (50799 in chips)
Seat 4: McLci (96663 in chips)
Seat 6: oldyellowbricks (156376 in chips)
Seat 7: phpro (24929 in chips)
Seat 8: ValeraB96 (114604 in chips)
thereaper2u: posts the ante 350
McLci: posts the ante 350
oldyellowbricks: posts the ante 350
phpro: posts the ante 350
ValeraB96: posts the ante 350
McLci: posts small blind 1400
oldyellowbricks: posts big blind 2800
*** HOLE CARDS ***
Dealt to phpro [5h Qh]
phpro: folds
ValeraB96: folds
thereaper2u: folds
McLci: folds
Uncalled bet (1400) returned to oldyellowbricks
oldyellowbricks collected 4550 from pot
oldyellowbricks: doesn't show hand
*** SUMMARY ***
Total pot 4550 | Rake 0
Seat 3: thereaper2u (button) folded before Flop (didn't bet)
Seat 4: McLci (small blind) folded before Flop
Seat 6: oldyellowbricks (big blind) collected (4550)
Seat 7: phpro folded before Flop (didn't bet)
Seat 8: ValeraB96 folded before Flop (didn't bet)


*********** # 248 **************
PokerStars Hand #257047945202: Tournament #3910307458, $0.98+$0.12 USD Hold'em No Limit - Level XXIV (1400/2800) - 2025/07/22 13:38:13 ET
Table '3910307458 19' 9-max Seat #4 is the button
Seat 3: thereaper2u (50449 in chips)
Seat 4: McLci (94913 in chips)
Seat 6: oldyellowbricks (159176 in chips)
Seat 7: phpro (24579 in chips)
Seat 8: ValeraB96 (114254 in chips)
thereaper2u: posts the ante 350
McLci: posts the ante 350
oldyellowbricks: posts the ante 350
phpro: posts the ante 350
ValeraB96: posts the ante 350
oldyellowbricks: posts small blind 1400
phpro: posts big blind 2800
*** HOLE CARDS ***
Dealt to phpro [Td Kc]
ValeraB96: folds
thereaper2u: folds
McLci: folds
oldyellowbricks: raises 156026 to 158826 and is all-in
phpro: folds
Uncalled bet (156026) returned to oldyellowbricks
oldyellowbricks collected 7350 from pot
oldyellowbricks: doesn't show hand
*** SUMMARY ***
Total pot 7350 | Rake 0
Seat 3: thereaper2u folded before Flop (didn't bet)
Seat 4: McLci (button) folded before Flop (didn't bet)
Seat 6: oldyellowbricks (small blind) collected (7350)
Seat 7: phpro (big blind) folded before Flop
Seat 8: ValeraB96 folded before Flop (didn't bet)


*********** # 249 **************
PokerStars Hand #257047949418: Tournament #3910307458, $0.98+$0.12 USD Hold'em No Limit - Level XXIV (1400/2800) - 2025/07/22 13:38:36 ET
Table '3910307458 19' 9-max Seat #6 is the button
Seat 3: thereaper2u (50099 in chips)
Seat 4: McLci (94563 in chips)
Seat 6: oldyellowbricks (163376 in chips)
Seat 7: phpro (21429 in chips)
Seat 8: ValeraB96 (113904 in chips)
thereaper2u: posts the ante 350
McLci: posts the ante 350
oldyellowbricks: posts the ante 350
phpro: posts the ante 350
ValeraB96: posts the ante 350
phpro: posts small blind 1400
ValeraB96: posts big blind 2800
*** HOLE CARDS ***
Dealt to phpro [Ac Td]
thereaper2u: folds
McLci: folds
oldyellowbricks: raises 2800 to 5600
phpro: raises 15479 to 21079 and is all-in
ValeraB96: folds
oldyellowbricks: folds
Uncalled bet (15479) returned to phpro
phpro collected 15750 from pot
phpro: doesn't show hand
*** SUMMARY ***
Total pot 15750 | Rake 0
Seat 3: thereaper2u folded before Flop (didn't bet)
Seat 4: McLci folded before Flop (didn't bet)
Seat 6: oldyellowbricks (button) folded before Flop
Seat 7: phpro (small blind) collected (15750)
Seat 8: ValeraB96 (big blind) folded before Flop


*********** # 250 **************
PokerStars Hand #257047955777: Tournament #3910307458, $0.98+$0.12 USD Hold'em No Limit - Level XXIV (1400/2800) - 2025/07/22 13:39:08 ET
Table '3910307458 19' 9-max Seat #7 is the button
Seat 3: thereaper2u (49749 in chips)
Seat 4: McLci (94213 in chips)
Seat 6: oldyellowbricks (157426 in chips)
Seat 7: phpro (31229 in chips)
Seat 8: ValeraB96 (110754 in chips)
thereaper2u: posts the ante 350
McLci: posts the ante 350
oldyellowbricks: posts the ante 350
phpro: posts the ante 350
ValeraB96: posts the ante 350
ValeraB96: posts small blind 1400
thereaper2u: posts big blind 2800
*** HOLE CARDS ***
Dealt to phpro [8s 8c]
McLci: folds
oldyellowbricks: raises 2800 to 5600
phpro: folds
ValeraB96: folds
thereaper2u: folds
Uncalled bet (2800) returned to oldyellowbricks
oldyellowbricks collected 8750 from pot
oldyellowbricks: doesn't show hand
*** SUMMARY ***
Total pot 8750 | Rake 0
Seat 3: thereaper2u (big blind) folded before Flop
Seat 4: McLci folded before Flop (didn't bet)
Seat 6: oldyellowbricks collected (8750)
Seat 7: phpro (button) folded before Flop (didn't bet)
Seat 8: ValeraB96 (small blind) folded before Flop


*********** # 251 **************
PokerStars Hand #257047960971: Tournament #3910307458, $0.98+$0.12 USD Hold'em No Limit - Level XXV (1600/3200) - 2025/07/22 13:39:35 ET
Table '3910307458 19' 9-max Seat #8 is the button
Seat 3: thereaper2u (46599 in chips)
Seat 4: McLci (93863 in chips)
Seat 6: oldyellowbricks (163026 in chips)
Seat 7: phpro (30879 in chips)
Seat 8: ValeraB96 (109004 in chips)
thereaper2u: posts the ante 400
McLci: posts the ante 400
oldyellowbricks: posts the ante 400
phpro: posts the ante 400
ValeraB96: posts the ante 400
thereaper2u: posts small blind 1600
McLci: posts big blind 3200
*** HOLE CARDS ***
Dealt to phpro [5s 2s]
oldyellowbricks: raises 3200 to 6400
phpro: folds
ValeraB96: raises 15360 to 21760
thereaper2u: folds
McLci: folds
oldyellowbricks: folds
Uncalled bet (15360) returned to ValeraB96
ValeraB96 collected 19600 from pot
ValeraB96: doesn't show hand
*** SUMMARY ***
Total pot 19600 | Rake 0
Seat 3: thereaper2u (small blind) folded before Flop
Seat 4: McLci (big blind) folded before Flop
Seat 6: oldyellowbricks folded before Flop
Seat 7: phpro folded before Flop (didn't bet)
Seat 8: ValeraB96 (button) collected (19600)


*********** # 252 **************
PokerStars Hand #257047964265: Tournament #3910307458, $0.98+$0.12 USD Hold'em No Limit - Level XXV (1600/3200) - 2025/07/22 13:39:53 ET
Table '3910307458 19' 9-max Seat #3 is the button
Seat 3: thereaper2u (44599 in chips)
Seat 4: McLci (90263 in chips)
Seat 6: oldyellowbricks (156226 in chips)
Seat 7: phpro (30479 in chips)
Seat 8: ValeraB96 (121804 in chips)
thereaper2u: posts the ante 400
McLci: posts the ante 400
oldyellowbricks: posts the ante 400
phpro: posts the ante 400
ValeraB96: posts the ante 400
McLci: posts small blind 1600
oldyellowbricks: posts big blind 3200
*** HOLE CARDS ***
Dealt to phpro [2d 4c]
phpro: folds
ValeraB96: folds
thereaper2u: folds
McLci: calls 1600
oldyellowbricks: raises 6400 to 9600
McLci: folds
Uncalled bet (6400) returned to oldyellowbricks
oldyellowbricks collected 8400 from pot
oldyellowbricks: doesn't show hand
*** SUMMARY ***
Total pot 8400 | Rake 0
Seat 3: thereaper2u (button) folded before Flop (didn't bet)
Seat 4: McLci (small blind) folded before Flop
Seat 6: oldyellowbricks (big blind) collected (8400)
Seat 7: phpro folded before Flop (didn't bet)
Seat 8: ValeraB96 folded before Flop (didn't bet)


*********** # 253 **************
PokerStars Hand #257047971009: Tournament #3910307458, $0.98+$0.12 USD Hold'em No Limit - Level XXV (1600/3200) - 2025/07/22 13:40:27 ET
Table '3910307458 19' 9-max Seat #4 is the button
Seat 3: thereaper2u (44199 in chips)
Seat 4: McLci (86663 in chips)
Seat 6: oldyellowbricks (161026 in chips)
Seat 7: phpro (30079 in chips)
Seat 8: ValeraB96 (121404 in chips)
thereaper2u: posts the ante 400
McLci: posts the ante 400
oldyellowbricks: posts the ante 400
phpro: posts the ante 400
ValeraB96: posts the ante 400
oldyellowbricks: posts small blind 1600
phpro: posts big blind 3200
*** HOLE CARDS ***
Dealt to phpro [Qd 6s]
ValeraB96: folds
thereaper2u: folds
McLci: folds
oldyellowbricks: folds
Uncalled bet (1600) returned to phpro
phpro collected 5200 from pot
phpro: doesn't show hand
*** SUMMARY ***
Total pot 5200 | Rake 0
Seat 3: thereaper2u folded before Flop (didn't bet)
Seat 4: McLci (button) folded before Flop (didn't bet)
Seat 6: oldyellowbricks (small blind) folded before Flop
Seat 7: phpro (big blind) collected (5200)
Seat 8: ValeraB96 folded before Flop (didn't bet)


*********** # 254 **************
PokerStars Hand #257047973923: Tournament #3910307458, $0.98+$0.12 USD Hold'em No Limit - Level XXV (1600/3200) - 2025/07/22 13:40:43 ET
Table '3910307458 19' 9-max Seat #6 is the button
Seat 3: thereaper2u (43799 in chips)
Seat 4: McLci (86263 in chips)
Seat 6: oldyellowbricks (159026 in chips)
Seat 7: phpro (33279 in chips)
Seat 8: ValeraB96 (121004 in chips)
thereaper2u: posts the ante 400
McLci: posts the ante 400
oldyellowbricks: posts the ante 400
phpro: posts the ante 400
ValeraB96: posts the ante 400
phpro: posts small blind 1600
ValeraB96: posts big blind 3200
*** HOLE CARDS ***
Dealt to phpro [Kh 8s]
thereaper2u: folds
McLci: folds
oldyellowbricks: folds
phpro: raises 3200 to 6400
ValeraB96: folds
Uncalled bet (3200) returned to phpro
phpro collected 8400 from pot
phpro: doesn't show hand
*** SUMMARY ***
Total pot 8400 | Rake 0
Seat 3: thereaper2u folded before Flop (didn't bet)
Seat 4: McLci folded before Flop (didn't bet)
Seat 6: oldyellowbricks (button) folded before Flop (didn't bet)
Seat 7: phpro (small blind) collected (8400)
Seat 8: ValeraB96 (big blind) folded before Flop


*********** # 255 **************
PokerStars Hand #257047982426: Tournament #3910307458, $0.98+$0.12 USD Hold'em No Limit - Level XXV (1600/3200) - 2025/07/22 13:41:28 ET
Table '3910307458 19' 9-max Seat #7 is the button
Seat 3: thereaper2u (43399 in chips)
Seat 4: McLci (85863 in chips)
Seat 6: oldyellowbricks (158626 in chips)
Seat 7: phpro (38079 in chips)
Seat 8: ValeraB96 (117404 in chips)
thereaper2u: posts the ante 400
McLci: posts the ante 400
oldyellowbricks: posts the ante 400
phpro: posts the ante 400
ValeraB96: posts the ante 400
ValeraB96: posts small blind 1600
thereaper2u: posts big blind 3200
*** HOLE CARDS ***
Dealt to phpro [Jh Kd]
McLci: folds
oldyellowbricks: folds
phpro: raises 3200 to 6400
ValeraB96: raises 108800 to 115200
thereaper2u: folds
phpro: folds
Uncalled bet (108800) returned to ValeraB96
ValeraB96 collected 18000 from pot
ValeraB96: doesn't show hand
*** SUMMARY ***
Total pot 18000 | Rake 0
Seat 3: thereaper2u (big blind) folded before Flop
Seat 4: McLci folded before Flop (didn't bet)
Seat 6: oldyellowbricks folded before Flop (didn't bet)
Seat 7: phpro (button) folded before Flop
Seat 8: ValeraB96 (small blind) collected (18000)


*********** # 256 **************
PokerStars Hand #257047989812: Tournament #3910307458, $0.98+$0.12 USD Hold'em No Limit - Level XXV (1600/3200) - 2025/07/22 13:42:06 ET
Table '3910307458 19' 9-max Seat #8 is the button
Seat 3: thereaper2u (39799 in chips)
Seat 4: McLci (85463 in chips)
Seat 6: oldyellowbricks (158226 in chips)
Seat 7: phpro (31279 in chips)
Seat 8: ValeraB96 (128604 in chips)
thereaper2u: posts the ante 400
McLci: posts the ante 400
oldyellowbricks: posts the ante 400
phpro: posts the ante 400
ValeraB96: posts the ante 400
thereaper2u: posts small blind 1600
McLci: posts big blind 3200
*** HOLE CARDS ***
Dealt to phpro [Ac Qd]
oldyellowbricks: folds
phpro: raises 27679 to 30879 and is all-in
ValeraB96: folds
thereaper2u: folds
McLci: calls 27679
*** FLOP *** [7h 3h Kc]
*** TURN *** [7h 3h Kc] [2h]
*** RIVER *** [7h 3h Kc 2h] [Ts]
*** SHOW DOWN ***
McLci: shows [Qs Js] (high card King)
phpro: shows [Ac Qd] (high card Ace)
phpro collected 65358 from pot
*** SUMMARY ***
Total pot 65358 | Rake 0
Board [7h 3h Kc 2h Ts]
Seat 3: thereaper2u (small blind) folded before Flop
Seat 4: McLci (big blind) showed [Qs Js] and lost with high card King
Seat 6: oldyellowbricks folded before Flop (didn't bet)
Seat 7: phpro showed [Ac Qd] and won (65358) with high card Ace
Seat 8: ValeraB96 (button) folded before Flop (didn't bet)


*********** # 257 **************
PokerStars Hand #257047999510: Tournament #3910307458, $0.98+$0.12 USD Hold'em No Limit - Level XXV (1600/3200) - 2025/07/22 13:42:56 ET
Table '3910307458 19' 9-max Seat #3 is the button
Seat 3: thereaper2u (37799 in chips)
Seat 4: McLci (54184 in chips)
Seat 6: oldyellowbricks (157826 in chips)
Seat 7: phpro (65358 in chips)
Seat 8: ValeraB96 (128204 in chips)
thereaper2u: posts the ante 400
McLci: posts the ante 400
oldyellowbricks: posts the ante 400
phpro: posts the ante 400
ValeraB96: posts the ante 400
McLci: posts small blind 1600
oldyellowbricks: posts big blind 3200
*** HOLE CARDS ***
Dealt to phpro [5d 8d]
phpro: folds
ValeraB96: folds
thereaper2u: raises 34199 to 37399 and is all-in
McLci: raises 16385 to 53784 and is all-in
oldyellowbricks: folds
Uncalled bet (16385) returned to McLci
*** FLOP *** [Qh 7h Kd]
*** TURN *** [Qh 7h Kd] [8s]
*** RIVER *** [Qh 7h Kd 8s] [6d]
*** SHOW DOWN ***
McLci: shows [Td Tc] (a pair of Tens)
thereaper2u: shows [5h 5s] (a pair of Fives)
McLci collected 79998 from pot
thereaper2u finished the tournament in 10th place and received $5.04.
*** SUMMARY ***
Total pot 79998 | Rake 0
Board [Qh 7h Kd 8s 6d]
Seat 3: thereaper2u (button) showed [5h 5s] and lost with a pair of Fives
Seat 4: McLci (small blind) showed [Td Tc] and won (79998) with a pair of Tens
Seat 6: oldyellowbricks (big blind) folded before Flop
Seat 7: phpro folded before Flop (didn't bet)
Seat 8: ValeraB96 folded before Flop (didn't bet)


*********** # 258 **************
PokerStars Hand #257048005447: Tournament #3910307458, $0.98+$0.12 USD Hold'em No Limit - Level XXV (1600/3200) - 2025/07/22 13:43:27 ET
Table '3910307458 12' 9-max Seat #4 is the button
Seat 1: oldyellowbricks (154226 in chips)
Seat 2: dimasiktuta (74261 in chips)
Seat 3: -MVC Tighty- (84980 in chips)
Seat 4: D.Leonoff (54726 in chips)
Seat 5: ValeraB96 (127804 in chips) out of hand (moved from another table into small blind)
Seat 6: phpro (64958 in chips) out of hand (moved from another table into small blind)
Seat 7: 7SkYy (82587 in chips)
Seat 8: bullen1414 (124075 in chips)
Seat 9: McLci (96383 in chips)
ValeraB96 will be allowed to play after the button
phpro will be allowed to play after the button
oldyellowbricks: posts the ante 400
dimasiktuta: posts the ante 400
-MVC Tighty-: posts the ante 400
D.Leonoff: posts the ante 400
7SkYy: posts the ante 400
bullen1414: posts the ante 400
McLci: posts the ante 400
7SkYy: posts small blind 1600
bullen1414: posts big blind 3200
*** HOLE CARDS ***
McLci: raises 3200 to 6400
oldyellowbricks: folds
dimasiktuta: folds
-MVC Tighty-: raises 9600 to 16000
D.Leonoff: folds
7SkYy: folds
bullen1414: folds
McLci: raises 19200 to 35200
-MVC Tighty-: folds
Uncalled bet (19200) returned to McLci
McLci collected 39600 from pot
McLci: doesn't show hand
*** SUMMARY ***
Total pot 39600 | Rake 0
Seat 1: oldyellowbricks folded before Flop (didn't bet)
Seat 2: dimasiktuta folded before Flop (didn't bet)
Seat 3: -MVC Tighty- folded before Flop
Seat 4: D.Leonoff (button) folded before Flop (didn't bet)
Seat 7: 7SkYy (small blind) folded before Flop
Seat 8: bullen1414 (big blind) folded before Flop
Seat 9: McLci collected (39600)


*********** # 259 **************
PokerStars Hand #257048012585: Tournament #3910307458, $0.98+$0.12 USD Hold'em No Limit - Level XXV (1600/3200) - 2025/07/22 13:44:04 ET
Table '3910307458 12' 9-max Seat #7 is the button
Seat 1: oldyellowbricks (153826 in chips)
Seat 2: dimasiktuta (73861 in chips)
Seat 3: -MVC Tighty- (68580 in chips)
Seat 4: D.Leonoff (54326 in chips)
Seat 5: ValeraB96 (127804 in chips)
Seat 6: phpro (64958 in chips)
Seat 7: 7SkYy (80587 in chips)
Seat 8: bullen1414 (120475 in chips)
Seat 9: McLci (119583 in chips)
oldyellowbricks: posts the ante 400
dimasiktuta: posts the ante 400
-MVC Tighty-: posts the ante 400
D.Leonoff: posts the ante 400
ValeraB96: posts the ante 400
phpro: posts the ante 400
7SkYy: posts the ante 400
bullen1414: posts the ante 400
McLci: posts the ante 400
bullen1414: posts small blind 1600
McLci: posts big blind 3200
*** HOLE CARDS ***
Dealt to phpro [Jh 4s]
oldyellowbricks: folds
dimasiktuta: folds
-MVC Tighty-: folds
D.Leonoff: folds
ValeraB96: folds
phpro: folds
7SkYy: raises 3200 to 6400
bullen1414: folds
McLci: calls 3200
*** FLOP *** [Ac Th 5s]
McLci: checks
7SkYy: bets 4500
McLci: calls 4500
*** TURN *** [Ac Th 5s] [Tc]
McLci: checks
7SkYy: bets 13500
McLci: folds
Uncalled bet (13500) returned to 7SkYy
7SkYy collected 27000 from pot
7SkYy: doesn't show hand
*** SUMMARY ***
Total pot 27000 | Rake 0
Board [Ac Th 5s Tc]
Seat 1: oldyellowbricks folded before Flop (didn't bet)
Seat 2: dimasiktuta folded before Flop (didn't bet)
Seat 3: -MVC Tighty- folded before Flop (didn't bet)
Seat 4: D.Leonoff folded before Flop (didn't bet)
Seat 5: ValeraB96 folded before Flop (didn't bet)
Seat 6: phpro folded before Flop (didn't bet)
Seat 7: 7SkYy (button) collected (27000)
Seat 8: bullen1414 (small blind) folded before Flop
Seat 9: McLci (big blind) folded on the Turn


*********** # 260 **************
PokerStars Hand #257048025198: Tournament #3910307458, $0.98+$0.12 USD Hold'em No Limit - Level XXV (1600/3200) - 2025/07/22 13:45:10 ET
Table '3910307458 12' 9-max Seat #8 is the button
Seat 1: oldyellowbricks (153426 in chips)
Seat 2: dimasiktuta (73461 in chips)
Seat 3: -MVC Tighty- (68180 in chips)
Seat 4: D.Leonoff (53926 in chips)
Seat 5: ValeraB96 (127404 in chips)
Seat 6: phpro (64558 in chips)
Seat 7: 7SkYy (96287 in chips)
Seat 8: bullen1414 (118475 in chips)
Seat 9: McLci (108283 in chips)
oldyellowbricks: posts the ante 400
dimasiktuta: posts the ante 400
-MVC Tighty-: posts the ante 400
D.Leonoff: posts the ante 400
ValeraB96: posts the ante 400
phpro: posts the ante 400
7SkYy: posts the ante 400
bullen1414: posts the ante 400
McLci: posts the ante 400
McLci: posts small blind 1600
oldyellowbricks: posts big blind 3200
*** HOLE CARDS ***
Dealt to phpro [4h 3d]
dimasiktuta: folds
-MVC Tighty-: folds
D.Leonoff: folds
ValeraB96: folds
phpro: folds
7SkYy: folds
bullen1414: folds
McLci: raises 6400 to 9600
oldyellowbricks: folds
Uncalled bet (6400) returned to McLci
McLci collected 10000 from pot
McLci: doesn't show hand
*** SUMMARY ***
Total pot 10000 | Rake 0
Seat 1: oldyellowbricks (big blind) folded before Flop
Seat 2: dimasiktuta folded before Flop (didn't bet)
Seat 3: -MVC Tighty- folded before Flop (didn't bet)
Seat 4: D.Leonoff folded before Flop (didn't bet)
Seat 5: ValeraB96 folded before Flop (didn't bet)
Seat 6: phpro folded before Flop (didn't bet)
Seat 7: 7SkYy folded before Flop (didn't bet)
Seat 8: bullen1414 (button) folded before Flop (didn't bet)
Seat 9: McLci (small blind) collected (10000)


*********** # 261 **************
PokerStars Hand #257048029322: Tournament #3910307458, $0.98+$0.12 USD Hold'em No Limit - Level XXV (1600/3200) - 2025/07/22 13:45:31 ET
Table '3910307458 12' 9-max Seat #9 is the button
Seat 1: oldyellowbricks (149826 in chips)
Seat 2: dimasiktuta (73061 in chips)
Seat 3: -MVC Tighty- (67780 in chips)
Seat 4: D.Leonoff (53526 in chips)
Seat 5: ValeraB96 (127004 in chips)
Seat 6: phpro (64158 in chips)
Seat 7: 7SkYy (95887 in chips)
Seat 8: bullen1414 (118075 in chips)
Seat 9: McLci (114683 in chips)
oldyellowbricks: posts the ante 400
dimasiktuta: posts the ante 400
-MVC Tighty-: posts the ante 400
D.Leonoff: posts the ante 400
ValeraB96: posts the ante 400
phpro: posts the ante 400
7SkYy: posts the ante 400
bullen1414: posts the ante 400
McLci: posts the ante 400
oldyellowbricks: posts small blind 1600
dimasiktuta: posts big blind 3200
*** HOLE CARDS ***
Dealt to phpro [5d 3s]
-MVC Tighty-: folds
D.Leonoff: folds
ValeraB96: raises 3200 to 6400
phpro: folds
7SkYy: folds
bullen1414: folds
McLci: raises 12800 to 19200
oldyellowbricks: folds
dimasiktuta: folds
ValeraB96: folds
Uncalled bet (12800) returned to McLci
McLci collected 21200 from pot
McLci: doesn't show hand
*** SUMMARY ***
Total pot 21200 | Rake 0
Seat 1: oldyellowbricks (small blind) folded before Flop
Seat 2: dimasiktuta (big blind) folded before Flop
Seat 3: -MVC Tighty- folded before Flop (didn't bet)
Seat 4: D.Leonoff folded before Flop (didn't bet)
Seat 5: ValeraB96 folded before Flop
Seat 6: phpro folded before Flop (didn't bet)
Seat 7: 7SkYy folded before Flop (didn't bet)
Seat 8: bullen1414 folded before Flop (didn't bet)
Seat 9: McLci (button) collected (21200)


*********** # 262 **************
PokerStars Hand #257048033737: Tournament #3910307458, $0.98+$0.12 USD Hold'em No Limit - Level XXV (1600/3200) - 2025/07/22 13:45:54 ET
Table '3910307458 12' 9-max Seat #1 is the button
Seat 1: oldyellowbricks (147826 in chips)
Seat 2: dimasiktuta (69461 in chips)
Seat 3: -MVC Tighty- (67380 in chips)
Seat 4: D.Leonoff (53126 in chips)
Seat 5: ValeraB96 (120204 in chips)
Seat 6: phpro (63758 in chips)
Seat 7: 7SkYy (95487 in chips)
Seat 8: bullen1414 (117675 in chips)
Seat 9: McLci (129083 in chips)
oldyellowbricks: posts the ante 400
dimasiktuta: posts the ante 400
-MVC Tighty-: posts the ante 400
D.Leonoff: posts the ante 400
ValeraB96: posts the ante 400
phpro: posts the ante 400
7SkYy: posts the ante 400
bullen1414: posts the ante 400
McLci: posts the ante 400
dimasiktuta: posts small blind 1600
-MVC Tighty-: posts big blind 3200
*** HOLE CARDS ***
Dealt to phpro [4c 5s]
D.Leonoff: folds
ValeraB96: folds
phpro: folds
7SkYy: folds
bullen1414: folds
McLci: folds
oldyellowbricks: raises 3200 to 6400
dimasiktuta: folds
-MVC Tighty-: calls 3200
*** FLOP *** [8h Jh Tc]
-MVC Tighty-: checks
oldyellowbricks: bets 5940
-MVC Tighty-: folds
Uncalled bet (5940) returned to oldyellowbricks
oldyellowbricks collected 18000 from pot
*** SUMMARY ***
Total pot 18000 | Rake 0
Board [8h Jh Tc]
Seat 1: oldyellowbricks (button) collected (18000)
Seat 2: dimasiktuta (small blind) folded before Flop
Seat 3: -MVC Tighty- (big blind) folded on the Flop
Seat 4: D.Leonoff folded before Flop (didn't bet)
Seat 5: ValeraB96 folded before Flop (didn't bet)
Seat 6: phpro folded before Flop (didn't bet)
Seat 7: 7SkYy folded before Flop (didn't bet)
Seat 8: bullen1414 folded before Flop (didn't bet)
Seat 9: McLci folded before Flop (didn't bet)


*********** # 263 **************
PokerStars Hand #257048040333: Tournament #3910307458, $0.98+$0.12 USD Hold'em No Limit - Level XXV (1600/3200) - 2025/07/22 13:46:28 ET
Table '3910307458 12' 9-max Seat #2 is the button
Seat 1: oldyellowbricks (159026 in chips)
Seat 2: dimasiktuta (67461 in chips)
Seat 3: -MVC Tighty- (60580 in chips)
Seat 4: D.Leonoff (52726 in chips)
Seat 5: ValeraB96 (119804 in chips)
Seat 6: phpro (63358 in chips)
Seat 7: 7SkYy (95087 in chips)
Seat 8: bullen1414 (117275 in chips)
Seat 9: McLci (128683 in chips)
oldyellowbricks: posts the ante 400
dimasiktuta: posts the ante 400
-MVC Tighty-: posts the ante 400
D.Leonoff: posts the ante 400
ValeraB96: posts the ante 400
phpro: posts the ante 400
7SkYy: posts the ante 400
bullen1414: posts the ante 400
McLci: posts the ante 400
-MVC Tighty-: posts small blind 1600
D.Leonoff: posts big blind 3200
*** HOLE CARDS ***
Dealt to phpro [3d 9h]
ValeraB96: folds
phpro: folds
7SkYy: folds
bullen1414: folds
McLci: folds
oldyellowbricks: folds
dimasiktuta: folds
-MVC Tighty-: folds
Uncalled bet (1600) returned to D.Leonoff
D.Leonoff collected 6800 from pot
D.Leonoff: doesn't show hand
*** SUMMARY ***
Total pot 6800 | Rake 0
Seat 1: oldyellowbricks folded before Flop (didn't bet)
Seat 2: dimasiktuta (button) folded before Flop (didn't bet)
Seat 3: -MVC Tighty- (small blind) folded before Flop
Seat 4: D.Leonoff (big blind) collected (6800)
Seat 5: ValeraB96 folded before Flop (didn't bet)
Seat 6: phpro folded before Flop (didn't bet)
Seat 7: 7SkYy folded before Flop (didn't bet)
Seat 8: bullen1414 folded before Flop (didn't bet)
Seat 9: McLci folded before Flop (didn't bet)


*********** # 264 **************
PokerStars Hand #257048043918: Tournament #3910307458, $0.98+$0.12 USD Hold'em No Limit - Level XXV (1600/3200) - 2025/07/22 13:46:47 ET
Table '3910307458 12' 9-max Seat #3 is the button
Seat 1: oldyellowbricks (158626 in chips)
Seat 2: dimasiktuta (67061 in chips)
Seat 3: -MVC Tighty- (58580 in chips)
Seat 4: D.Leonoff (57526 in chips)
Seat 5: ValeraB96 (119404 in chips)
Seat 6: phpro (62958 in chips)
Seat 7: 7SkYy (94687 in chips)
Seat 8: bullen1414 (116875 in chips)
Seat 9: McLci (128283 in chips)
oldyellowbricks: posts the ante 400
dimasiktuta: posts the ante 400
-MVC Tighty-: posts the ante 400
D.Leonoff: posts the ante 400
ValeraB96: posts the ante 400
phpro: posts the ante 400
7SkYy: posts the ante 400
bullen1414: posts the ante 400
McLci: posts the ante 400
D.Leonoff: posts small blind 1600
ValeraB96: posts big blind 3200
*** HOLE CARDS ***
Dealt to phpro [Jd 6c]
phpro: folds
7SkYy: folds
bullen1414: folds
McLci: folds
oldyellowbricks: folds
dimasiktuta: folds
-MVC Tighty-: folds
D.Leonoff: raises 6400 to 9600
ValeraB96: folds
Uncalled bet (6400) returned to D.Leonoff
D.Leonoff collected 10000 from pot
D.Leonoff: doesn't show hand
*** SUMMARY ***
Total pot 10000 | Rake 0
Seat 1: oldyellowbricks folded before Flop (didn't bet)
Seat 2: dimasiktuta folded before Flop (didn't bet)
Seat 3: -MVC Tighty- (button) folded before Flop (didn't bet)
Seat 4: D.Leonoff (small blind) collected (10000)
Seat 5: ValeraB96 (big blind) folded before Flop
Seat 6: phpro folded before Flop (didn't bet)
Seat 7: 7SkYy folded before Flop (didn't bet)
Seat 8: bullen1414 folded before Flop (didn't bet)
Seat 9: McLci folded before Flop (didn't bet)


*********** # 265 **************
PokerStars Hand #257048049816: Tournament #3910307458, $0.98+$0.12 USD Hold'em No Limit - Level XXV (1600/3200) - 2025/07/22 13:47:17 ET
Table '3910307458 12' 9-max Seat #4 is the button
Seat 1: oldyellowbricks (158226 in chips)
Seat 2: dimasiktuta (66661 in chips)
Seat 3: -MVC Tighty- (58180 in chips)
Seat 4: D.Leonoff (63926 in chips)
Seat 5: ValeraB96 (115804 in chips)
Seat 6: phpro (62558 in chips)
Seat 7: 7SkYy (94287 in chips)
Seat 8: bullen1414 (116475 in chips)
Seat 9: McLci (127883 in chips)
oldyellowbricks: posts the ante 400
dimasiktuta: posts the ante 400
-MVC Tighty-: posts the ante 400
D.Leonoff: posts the ante 400
ValeraB96: posts the ante 400
phpro: posts the ante 400
7SkYy: posts the ante 400
bullen1414: posts the ante 400
McLci: posts the ante 400
ValeraB96: posts small blind 1600
phpro: posts big blind 3200
*** HOLE CARDS ***
Dealt to phpro [Js 4h]
7SkYy: folds
bullen1414: folds
McLci: folds
oldyellowbricks: raises 3200 to 6400
dimasiktuta: folds
-MVC Tighty-: folds
D.Leonoff: folds
ValeraB96: folds
phpro: folds
Uncalled bet (3200) returned to oldyellowbricks
oldyellowbricks collected 11600 from pot
oldyellowbricks: doesn't show hand
*** SUMMARY ***
Total pot 11600 | Rake 0
Seat 1: oldyellowbricks collected (11600)
Seat 2: dimasiktuta folded before Flop (didn't bet)
Seat 3: -MVC Tighty- folded before Flop (didn't bet)
Seat 4: D.Leonoff (button) folded before Flop (didn't bet)
Seat 5: ValeraB96 (small blind) folded before Flop
Seat 6: phpro (big blind) folded before Flop
Seat 7: 7SkYy folded before Flop (didn't bet)
Seat 8: bullen1414 folded before Flop (didn't bet)
Seat 9: McLci folded before Flop (didn't bet)


*********** # 266 **************
PokerStars Hand #257048053617: Tournament #3910307458, $0.98+$0.12 USD Hold'em No Limit - Level XXV (1600/3200) - 2025/07/22 13:47:37 ET
Table '3910307458 12' 9-max Seat #5 is the button
Seat 1: oldyellowbricks (166226 in chips)
Seat 2: dimasiktuta (66261 in chips)
Seat 3: -MVC Tighty- (57780 in chips)
Seat 4: D.Leonoff (63526 in chips)
Seat 5: ValeraB96 (113804 in chips)
Seat 6: phpro (58958 in chips)
Seat 7: 7SkYy (93887 in chips)
Seat 8: bullen1414 (116075 in chips)
Seat 9: McLci (127483 in chips)
oldyellowbricks: posts the ante 400
dimasiktuta: posts the ante 400
-MVC Tighty-: posts the ante 400
D.Leonoff: posts the ante 400
ValeraB96: posts the ante 400
phpro: posts the ante 400
7SkYy: posts the ante 400
bullen1414: posts the ante 400
McLci: posts the ante 400
phpro: posts small blind 1600
7SkYy: posts big blind 3200
*** HOLE CARDS ***
Dealt to phpro [Kd 4d]
bullen1414: folds
McLci: folds
oldyellowbricks: folds
dimasiktuta: raises 3200 to 6400
-MVC Tighty-: folds
D.Leonoff: folds
ValeraB96: folds
phpro: folds
7SkYy: folds
Uncalled bet (3200) returned to dimasiktuta
dimasiktuta collected 11600 from pot
dimasiktuta: doesn't show hand
*** SUMMARY ***
Total pot 11600 | Rake 0
Seat 1: oldyellowbricks folded before Flop (didn't bet)
Seat 2: dimasiktuta collected (11600)
Seat 3: -MVC Tighty- folded before Flop (didn't bet)
Seat 4: D.Leonoff folded before Flop (didn't bet)
Seat 5: ValeraB96 (button) folded before Flop (didn't bet)
Seat 6: phpro (small blind) folded before Flop
Seat 7: 7SkYy (big blind) folded before Flop
Seat 8: bullen1414 folded before Flop (didn't bet)
Seat 9: McLci folded before Flop (didn't bet)


*********** # 267 **************
PokerStars Hand #257048060306: Tournament #3910307458, $0.98+$0.12 USD Hold'em No Limit - Level XXV (1600/3200) - 2025/07/22 13:48:11 ET
Table '3910307458 12' 9-max Seat #6 is the button
Seat 1: oldyellowbricks (165826 in chips)
Seat 2: dimasiktuta (74261 in chips)
Seat 3: -MVC Tighty- (57380 in chips)
Seat 4: D.Leonoff (63126 in chips)
Seat 5: ValeraB96 (113404 in chips)
Seat 6: phpro (56958 in chips)
Seat 7: 7SkYy (90287 in chips)
Seat 8: bullen1414 (115675 in chips)
Seat 9: McLci (127083 in chips)
oldyellowbricks: posts the ante 400
dimasiktuta: posts the ante 400
-MVC Tighty-: posts the ante 400
D.Leonoff: posts the ante 400
ValeraB96: posts the ante 400
phpro: posts the ante 400
7SkYy: posts the ante 400
bullen1414: posts the ante 400
McLci: posts the ante 400
7SkYy: posts small blind 1600
bullen1414: posts big blind 3200
*** HOLE CARDS ***
Dealt to phpro [Ac Tc]
McLci: folds
oldyellowbricks: folds
dimasiktuta: folds
-MVC Tighty-: folds
D.Leonoff: folds
ValeraB96: raises 3200 to 6400
phpro: calls 6400
7SkYy: raises 83487 to 89887 and is all-in
bullen1414: folds
ValeraB96: folds
phpro: folds
Uncalled bet (83487) returned to 7SkYy
7SkYy collected 26000 from pot
7SkYy: doesn't show hand
*** SUMMARY ***
Total pot 26000 | Rake 0
Seat 1: oldyellowbricks folded before Flop (didn't bet)
Seat 2: dimasiktuta folded before Flop (didn't bet)
Seat 3: -MVC Tighty- folded before Flop (didn't bet)
Seat 4: D.Leonoff folded before Flop (didn't bet)
Seat 5: ValeraB96 folded before Flop
Seat 6: phpro (button) folded before Flop
Seat 7: 7SkYy (small blind) collected (26000)
Seat 8: bullen1414 (big blind) folded before Flop
Seat 9: McLci folded before Flop (didn't bet)


*********** # 268 **************
PokerStars Hand #257048067836: Tournament #3910307458, $0.98+$0.12 USD Hold'em No Limit - Level XXV (1600/3200) - 2025/07/22 13:48:49 ET
Table '3910307458 12' 9-max Seat #7 is the button
Seat 1: oldyellowbricks (165426 in chips)
Seat 2: dimasiktuta (73861 in chips)
Seat 3: -MVC Tighty- (56980 in chips)
Seat 4: D.Leonoff (62726 in chips)
Seat 5: ValeraB96 (106604 in chips)
Seat 6: phpro (50158 in chips)
Seat 7: 7SkYy (109487 in chips)
Seat 8: bullen1414 (112075 in chips)
Seat 9: McLci (126683 in chips)
oldyellowbricks: posts the ante 400
dimasiktuta: posts the ante 400
-MVC Tighty-: posts the ante 400
D.Leonoff: posts the ante 400
ValeraB96: posts the ante 400
phpro: posts the ante 400
7SkYy: posts the ante 400
bullen1414: posts the ante 400
McLci: posts the ante 400
bullen1414: posts small blind 1600
McLci: posts big blind 3200
*** HOLE CARDS ***
Dealt to phpro [8h 7c]
oldyellowbricks: raises 3200 to 6400
dimasiktuta: folds
-MVC Tighty-: folds
D.Leonoff: folds
ValeraB96: folds
phpro: folds
7SkYy: folds
bullen1414: folds
McLci: folds
Uncalled bet (3200) returned to oldyellowbricks
oldyellowbricks collected 11600 from pot
oldyellowbricks: doesn't show hand
*** SUMMARY ***
Total pot 11600 | Rake 0
Seat 1: oldyellowbricks collected (11600)
Seat 2: dimasiktuta folded before Flop (didn't bet)
Seat 3: -MVC Tighty- folded before Flop (didn't bet)
Seat 4: D.Leonoff folded before Flop (didn't bet)
Seat 5: ValeraB96 folded before Flop (didn't bet)
Seat 6: phpro folded before Flop (didn't bet)
Seat 7: 7SkYy (button) folded before Flop (didn't bet)
Seat 8: bullen1414 (small blind) folded before Flop
Seat 9: McLci (big blind) folded before Flop


*********** # 269 **************
PokerStars Hand #257048072667: Tournament #3910307458, $0.98+$0.12 USD Hold'em No Limit - Level XXV (1600/3200) - 2025/07/22 13:49:14 ET
Table '3910307458 12' 9-max Seat #8 is the button
Seat 1: oldyellowbricks (173426 in chips)
Seat 2: dimasiktuta (73461 in chips)
Seat 3: -MVC Tighty- (56580 in chips)
Seat 4: D.Leonoff (62326 in chips)
Seat 5: ValeraB96 (106204 in chips)
Seat 6: phpro (49758 in chips)
Seat 7: 7SkYy (109087 in chips)
Seat 8: bullen1414 (110075 in chips)
Seat 9: McLci (123083 in chips)
oldyellowbricks: posts the ante 400
dimasiktuta: posts the ante 400
-MVC Tighty-: posts the ante 400
D.Leonoff: posts the ante 400
ValeraB96: posts the ante 400
phpro: posts the ante 400
7SkYy: posts the ante 400
bullen1414: posts the ante 400
McLci: posts the ante 400
McLci: posts small blind 1600
oldyellowbricks: posts big blind 3200
*** HOLE CARDS ***
Dealt to phpro [6h Jd]
dimasiktuta: raises 3200 to 6400
-MVC Tighty-: folds
D.Leonoff: calls 6400
ValeraB96: folds
phpro: folds
7SkYy: folds
bullen1414: folds
McLci: folds
oldyellowbricks: calls 3200
*** FLOP *** [Ts Tc Kc]
oldyellowbricks: checks
dimasiktuta: bets 8540
D.Leonoff: folds
oldyellowbricks: calls 8540
*** TURN *** [Ts Tc Kc] [9c]
oldyellowbricks: checks
dimasiktuta: bets 14518
oldyellowbricks: folds
Uncalled bet (14518) returned to dimasiktuta
dimasiktuta collected 41480 from pot
dimasiktuta: doesn't show hand
*** SUMMARY ***
Total pot 41480 | Rake 0
Board [Ts Tc Kc 9c]
Seat 1: oldyellowbricks (big blind) folded on the Turn
Seat 2: dimasiktuta collected (41480)
Seat 3: -MVC Tighty- folded before Flop (didn't bet)
Seat 4: D.Leonoff folded on the Flop
Seat 5: ValeraB96 folded before Flop (didn't bet)
Seat 6: phpro folded before Flop (didn't bet)
Seat 7: 7SkYy folded before Flop (didn't bet)
Seat 8: bullen1414 (button) folded before Flop (didn't bet)
Seat 9: McLci (small blind) folded before Flop


*********** # 270 **************
PokerStars Hand #257048082161: Tournament #3910307458, $0.98+$0.12 USD Hold'em No Limit - Level XXVI (1800/3600) - 2025/07/22 13:50:02 ET
Table '3910307458 12' 9-max Seat #9 is the button
Seat 1: oldyellowbricks (158086 in chips)
Seat 2: dimasiktuta (99601 in chips)
Seat 3: -MVC Tighty- (56180 in chips)
Seat 4: D.Leonoff (55526 in chips)
Seat 5: ValeraB96 (105804 in chips)
Seat 6: phpro (49358 in chips)
Seat 7: 7SkYy (108687 in chips)
Seat 8: bullen1414 (109675 in chips)
Seat 9: McLci (121083 in chips)
oldyellowbricks: posts the ante 450
dimasiktuta: posts the ante 450
-MVC Tighty-: posts the ante 450
D.Leonoff: posts the ante 450
ValeraB96: posts the ante 450
phpro: posts the ante 450
7SkYy: posts the ante 450
bullen1414: posts the ante 450
McLci: posts the ante 450
oldyellowbricks: posts small blind 1800
dimasiktuta: posts big blind 3600
*** HOLE CARDS ***
Dealt to phpro [5s 5h]
-MVC Tighty-: folds
D.Leonoff: folds
ValeraB96: folds
phpro: folds
7SkYy: folds
bullen1414: raises 3960 to 7560
McLci: folds
oldyellowbricks: folds
dimasiktuta: calls 3960
*** FLOP *** [Ad 7s 9c]
dimasiktuta: bets 12582
bullen1414: folds
Uncalled bet (12582) returned to dimasiktuta
dimasiktuta collected 20970 from pot
dimasiktuta: doesn't show hand
*** SUMMARY ***
Total pot 20970 | Rake 0
Board [Ad 7s 9c]
Seat 1: oldyellowbricks (small blind) folded before Flop
Seat 2: dimasiktuta (big blind) collected (20970)
Seat 3: -MVC Tighty- folded before Flop (didn't bet)
Seat 4: D.Leonoff folded before Flop (didn't bet)
Seat 5: ValeraB96 folded before Flop (didn't bet)
Seat 6: phpro folded before Flop (didn't bet)
Seat 7: 7SkYy folded before Flop (didn't bet)
Seat 8: bullen1414 folded on the Flop
Seat 9: McLci (button) folded before Flop (didn't bet)


*********** # 271 **************
PokerStars Hand #257048090311: Tournament #3910307458, $0.98+$0.12 USD Hold'em No Limit - Level XXVI (1800/3600) - 2025/07/22 13:50:44 ET
Table '3910307458 12' 9-max Seat #1 is the button
Seat 1: oldyellowbricks (155836 in chips)
Seat 2: dimasiktuta (112561 in chips)
Seat 3: -MVC Tighty- (55730 in chips)
Seat 4: D.Leonoff (55076 in chips)
Seat 5: ValeraB96 (105354 in chips)
Seat 6: phpro (48908 in chips)
Seat 7: 7SkYy (108237 in chips)
Seat 8: bullen1414 (101665 in chips)
Seat 9: McLci (120633 in chips)
oldyellowbricks: posts the ante 450
dimasiktuta: posts the ante 450
-MVC Tighty-: posts the ante 450
D.Leonoff: posts the ante 450
ValeraB96: posts the ante 450
phpro: posts the ante 450
7SkYy: posts the ante 450
bullen1414: posts the ante 450
McLci: posts the ante 450
dimasiktuta: posts small blind 1800
-MVC Tighty-: posts big blind 3600
*** HOLE CARDS ***
Dealt to phpro [5d Ks]
D.Leonoff: folds
ValeraB96: folds
phpro: folds
7SkYy: folds
bullen1414: folds
McLci: folds
oldyellowbricks: folds
dimasiktuta: raises 3600 to 7200
-MVC Tighty-: raises 48080 to 55280 and is all-in
dimasiktuta: calls 48080
*** FLOP *** [8d 9s 2s]
*** TURN *** [8d 9s 2s] [6c]
*** RIVER *** [8d 9s 2s 6c] [3c]
*** SHOW DOWN ***
dimasiktuta: shows [Ac Qh] (high card Ace)
-MVC Tighty-: shows [Ah Js] (high card Ace - lower kicker)
dimasiktuta collected 114610 from pot
-MVC Tighty- finished the tournament in 9th place and received $6.34.
*** SUMMARY ***
Total pot 114610 | Rake 0
Board [8d 9s 2s 6c 3c]
Seat 1: oldyellowbricks (button) folded before Flop (didn't bet)
Seat 2: dimasiktuta (small blind) showed [Ac Qh] and won (114610) with high card Ace
Seat 3: -MVC Tighty- (big blind) showed [Ah Js] and lost with high card Ace
Seat 4: D.Leonoff folded before Flop (didn't bet)
Seat 5: ValeraB96 folded before Flop (didn't bet)
Seat 6: phpro folded before Flop (didn't bet)
Seat 7: 7SkYy folded before Flop (didn't bet)
Seat 8: bullen1414 folded before Flop (didn't bet)
Seat 9: McLci folded before Flop (didn't bet)


*********** # 272 **************
PokerStars Hand #257048097469: Tournament #3910307458, $0.98+$0.12 USD Hold'em No Limit - Level XXVI (1800/3600) - 2025/07/22 13:51:19 ET
Table '3910307458 12' 9-max Seat #2 is the button
Seat 1: oldyellowbricks (155386 in chips)
Seat 2: dimasiktuta (171441 in chips)
Seat 4: D.Leonoff (54626 in chips)
Seat 5: ValeraB96 (104904 in chips)
Seat 6: phpro (48458 in chips)
Seat 7: 7SkYy (107787 in chips)
Seat 8: bullen1414 (101215 in chips)
Seat 9: McLci (120183 in chips)
oldyellowbricks: posts the ante 450
dimasiktuta: posts the ante 450
D.Leonoff: posts the ante 450
ValeraB96: posts the ante 450
phpro: posts the ante 450
7SkYy: posts the ante 450
bullen1414: posts the ante 450
McLci: posts the ante 450
D.Leonoff: posts small blind 1800
ValeraB96: posts big blind 3600
*** HOLE CARDS ***
Dealt to phpro [Ts Ks]
phpro: folds
7SkYy: folds
bullen1414: folds
McLci: folds
oldyellowbricks: raises 3600 to 7200
dimasiktuta: calls 7200
D.Leonoff: folds
ValeraB96: raises 97254 to 104454 and is all-in
oldyellowbricks: folds
dimasiktuta: folds
Uncalled bet (97254) returned to ValeraB96
ValeraB96 collected 27000 from pot
ValeraB96: doesn't show hand
*** SUMMARY ***
Total pot 27000 | Rake 0
Seat 1: oldyellowbricks folded before Flop
Seat 2: dimasiktuta (button) folded before Flop
Seat 4: D.Leonoff (small blind) folded before Flop
Seat 5: ValeraB96 (big blind) collected (27000)
Seat 6: phpro folded before Flop (didn't bet)
Seat 7: 7SkYy folded before Flop (didn't bet)
Seat 8: bullen1414 folded before Flop (didn't bet)
Seat 9: McLci folded before Flop (didn't bet)


*********** # 273 **************
PokerStars Hand #257048102410: Tournament #3910307458, $0.98+$0.12 USD Hold'em No Limit - Level XXVI (1800/3600) - 2025/07/22 13:51:44 ET
Table '3910307458 12' 9-max Seat #4 is the button
Seat 1: oldyellowbricks (147736 in chips)
Seat 2: dimasiktuta (163791 in chips)
Seat 4: D.Leonoff (52376 in chips)
Seat 5: ValeraB96 (124254 in chips)
Seat 6: phpro (48008 in chips)
Seat 7: 7SkYy (107337 in chips)
Seat 8: bullen1414 (100765 in chips)
Seat 9: McLci (119733 in chips)
oldyellowbricks: posts the ante 450
dimasiktuta: posts the ante 450
D.Leonoff: posts the ante 450
ValeraB96: posts the ante 450
phpro: posts the ante 450
7SkYy: posts the ante 450
bullen1414: posts the ante 450
McLci: posts the ante 450
ValeraB96: posts small blind 1800
phpro: posts big blind 3600
*** HOLE CARDS ***
Dealt to phpro [Ts Qd]
7SkYy: folds
bullen1414: folds
McLci: folds
oldyellowbricks: folds
dimasiktuta: folds
D.Leonoff: raises 3960 to 7560
ValeraB96: folds
phpro: calls 3960
*** FLOP *** [Th Ad Kc]
phpro: bets 6772
D.Leonoff: calls 6772
*** TURN *** [Th Ad Kc] [6c]
phpro: bets 11241
D.Leonoff: raises 26353 to 37594 and is all-in
phpro: folds
Uncalled bet (26353) returned to D.Leonoff
D.Leonoff collected 56546 from pot
D.Leonoff: doesn't show hand
*** SUMMARY ***
Total pot 56546 | Rake 0
Board [Th Ad Kc 6c]
Seat 1: oldyellowbricks folded before Flop (didn't bet)
Seat 2: dimasiktuta folded before Flop (didn't bet)
Seat 4: D.Leonoff (button) collected (56546)
Seat 5: ValeraB96 (small blind) folded before Flop
Seat 6: phpro (big blind) folded on the Turn
Seat 7: 7SkYy folded before Flop (didn't bet)
Seat 8: bullen1414 folded before Flop (didn't bet)
Seat 9: McLci folded before Flop (didn't bet)


*********** # 274 **************
PokerStars Hand #257048114967: Tournament #3910307458, $0.98+$0.12 USD Hold'em No Limit - Level XXVI (1800/3600) - 2025/07/22 13:52:47 ET
Table '3910307458 12' 9-max Seat #5 is the button
Seat 1: oldyellowbricks (147286 in chips)
Seat 2: dimasiktuta (163341 in chips)
Seat 4: D.Leonoff (82899 in chips)
Seat 5: ValeraB96 (122004 in chips)
Seat 6: phpro (21985 in chips)
Seat 7: 7SkYy (106887 in chips)
Seat 8: bullen1414 (100315 in chips)
Seat 9: McLci (119283 in chips)
oldyellowbricks: posts the ante 450
dimasiktuta: posts the ante 450
D.Leonoff: posts the ante 450
ValeraB96: posts the ante 450
phpro: posts the ante 450
7SkYy: posts the ante 450
bullen1414: posts the ante 450
McLci: posts the ante 450
phpro: posts small blind 1800
7SkYy: posts big blind 3600
*** HOLE CARDS ***
Dealt to phpro [4h 9s]
bullen1414: folds
McLci: folds
oldyellowbricks: folds
dimasiktuta: folds
D.Leonoff: raises 3960 to 7560
ValeraB96: folds
phpro: folds
7SkYy: folds
Uncalled bet (3960) returned to D.Leonoff
D.Leonoff collected 12600 from pot
D.Leonoff: doesn't show hand
*** SUMMARY ***
Total pot 12600 | Rake 0
Seat 1: oldyellowbricks folded before Flop (didn't bet)
Seat 2: dimasiktuta folded before Flop (didn't bet)
Seat 4: D.Leonoff collected (12600)
Seat 5: ValeraB96 (button) folded before Flop (didn't bet)
Seat 6: phpro (small blind) folded before Flop
Seat 7: 7SkYy (big blind) folded before Flop
Seat 8: bullen1414 folded before Flop (didn't bet)
Seat 9: McLci folded before Flop (didn't bet)


*********** # 275 **************
PokerStars Hand #257048122652: Tournament #3910307458, $0.98+$0.12 USD Hold'em No Limit - Level XXVI (1800/3600) - 2025/07/22 13:53:26 ET
Table '3910307458 12' 9-max Seat #6 is the button
Seat 1: oldyellowbricks (146836 in chips)
Seat 2: dimasiktuta (162891 in chips)
Seat 4: D.Leonoff (91449 in chips)
Seat 5: ValeraB96 (121554 in chips)
Seat 6: phpro (19735 in chips)
Seat 7: 7SkYy (102837 in chips)
Seat 8: bullen1414 (99865 in chips)
Seat 9: McLci (118833 in chips)
oldyellowbricks: posts the ante 450
dimasiktuta: posts the ante 450
D.Leonoff: posts the ante 450
ValeraB96: posts the ante 450
phpro: posts the ante 450
7SkYy: posts the ante 450
bullen1414: posts the ante 450
McLci: posts the ante 450
7SkYy: posts small blind 1800
bullen1414: posts big blind 3600
*** HOLE CARDS ***
Dealt to phpro [3s Th]
McLci: folds
oldyellowbricks: folds
dimasiktuta: folds
D.Leonoff: folds
ValeraB96: folds
phpro: folds
7SkYy: calls 1800
bullen1414: checks
*** FLOP *** [3c Kh 4c]
7SkYy: bets 3600
bullen1414: calls 3600
*** TURN *** [3c Kh 4c] [6s]
7SkYy: bets 7200
bullen1414: calls 7200
*** RIVER *** [3c Kh 4c 6s] [8s]
7SkYy: bets 7200
bullen1414: calls 7200
*** SHOW DOWN ***
7SkYy: shows [5c 6d] (a pair of Sixes)
bullen1414: shows [Ks 2s] (a pair of Kings)
bullen1414 collected 46800 from pot
*** SUMMARY ***
Total pot 46800 | Rake 0
Board [3c Kh 4c 6s 8s]
Seat 1: oldyellowbricks folded before Flop (didn't bet)
Seat 2: dimasiktuta folded before Flop (didn't bet)
Seat 4: D.Leonoff folded before Flop (didn't bet)
Seat 5: ValeraB96 folded before Flop (didn't bet)
Seat 6: phpro (button) folded before Flop (didn't bet)
Seat 7: 7SkYy (small blind) showed [5c 6d] and lost with a pair of Sixes
Seat 8: bullen1414 (big blind) showed [Ks 2s] and won (46800) with a pair of Kings
Seat 9: McLci folded before Flop (didn't bet)


*********** # 276 **************
PokerStars Hand #257048135718: Tournament #3910307458, $0.98+$0.12 USD Hold'em No Limit - Level XXVI (1800/3600) - 2025/07/22 13:54:32 ET
Table '3910307458 12' 9-max Seat #7 is the button
Seat 1: oldyellowbricks (146386 in chips)
Seat 2: dimasiktuta (162441 in chips)
Seat 4: D.Leonoff (90999 in chips)
Seat 5: ValeraB96 (121104 in chips)
Seat 6: phpro (19285 in chips)
Seat 7: 7SkYy (80787 in chips)
Seat 8: bullen1414 (124615 in chips)
Seat 9: McLci (118383 in chips)
oldyellowbricks: posts the ante 450
dimasiktuta: posts the ante 450
D.Leonoff: posts the ante 450
ValeraB96: posts the ante 450
phpro: posts the ante 450
7SkYy: posts the ante 450
bullen1414: posts the ante 450
McLci: posts the ante 450
bullen1414: posts small blind 1800
McLci: posts big blind 3600
*** HOLE CARDS ***
Dealt to phpro [8c 5c]
oldyellowbricks: folds
dimasiktuta: folds
D.Leonoff: raises 3960 to 7560
ValeraB96: folds
phpro: folds
7SkYy: folds
bullen1414: folds
McLci: calls 3960
*** FLOP *** [3s 8d 6h]
McLci: bets 3600
D.Leonoff: calls 3600
*** TURN *** [3s 8d 6h] [Tc]
McLci: checks
D.Leonoff: checks
*** RIVER *** [3s 8d 6h Tc] [Qs]
McLci: checks
D.Leonoff: bets 9148
McLci: calls 9148
*** SHOW DOWN ***
D.Leonoff: shows [Qh Kc] (a pair of Queens)
McLci: mucks hand
D.Leonoff collected 46016 from pot
*** SUMMARY ***
Total pot 46016 | Rake 0
Board [3s 8d 6h Tc Qs]
Seat 1: oldyellowbricks folded before Flop (didn't bet)
Seat 2: dimasiktuta folded before Flop (didn't bet)
Seat 4: D.Leonoff showed [Qh Kc] and won (46016) with a pair of Queens
Seat 5: ValeraB96 folded before Flop (didn't bet)
Seat 6: phpro folded before Flop (didn't bet)
Seat 7: 7SkYy (button) folded before Flop (didn't bet)
Seat 8: bullen1414 (small blind) folded before Flop
Seat 9: McLci (big blind) mucked [6d 2d]


*********** # 277 **************
PokerStars Hand #257048188563: Tournament #3910307458, $0.98+$0.12 USD Hold'em No Limit - Level XXVI (1800/3600) - 2025/07/22 14:00:33 ET
Table '3910307458 12' 9-max Seat #8 is the button
Seat 1: oldyellowbricks (145936 in chips)
Seat 2: dimasiktuta (161991 in chips)
Seat 4: D.Leonoff (116257 in chips)
Seat 5: ValeraB96 (120654 in chips)
Seat 6: phpro (18835 in chips)
Seat 7: 7SkYy (80337 in chips)
Seat 8: bullen1414 (122365 in chips)
Seat 9: McLci (97625 in chips)
oldyellowbricks: posts the ante 450
dimasiktuta: posts the ante 450
D.Leonoff: posts the ante 450
ValeraB96: posts the ante 450
phpro: posts the ante 450
7SkYy: posts the ante 450
bullen1414: posts the ante 450
McLci: posts the ante 450
McLci: posts small blind 1800
oldyellowbricks: posts big blind 3600
*** HOLE CARDS ***
Dealt to phpro [2c 8c]
dimasiktuta: folds
D.Leonoff: folds
ValeraB96: folds
phpro: folds
7SkYy: folds
bullen1414: folds
McLci: folds
Uncalled bet (1800) returned to oldyellowbricks
oldyellowbricks collected 7200 from pot
oldyellowbricks: doesn't show hand
*** SUMMARY ***
Total pot 7200 | Rake 0
Seat 1: oldyellowbricks (big blind) collected (7200)
Seat 2: dimasiktuta folded before Flop (didn't bet)
Seat 4: D.Leonoff folded before Flop (didn't bet)
Seat 5: ValeraB96 folded before Flop (didn't bet)
Seat 6: phpro folded before Flop (didn't bet)
Seat 7: 7SkYy folded before Flop (didn't bet)
Seat 8: bullen1414 (button) folded before Flop (didn't bet)
Seat 9: McLci (small blind) folded before Flop


*********** # 278 **************
PokerStars Hand #257048193516: Tournament #3910307458, $0.98+$0.12 USD Hold'em No Limit - Level XXVI (1800/3600) - 2025/07/22 14:01:03 ET
Table '3910307458 12' 9-max Seat #9 is the button
Seat 1: oldyellowbricks (150886 in chips)
Seat 2: dimasiktuta (161541 in chips)
Seat 4: D.Leonoff (115807 in chips)
Seat 5: ValeraB96 (120204 in chips)
Seat 6: phpro (18385 in chips)
Seat 7: 7SkYy (79887 in chips)
Seat 8: bullen1414 (121915 in chips)
Seat 9: McLci (95375 in chips)
oldyellowbricks: posts the ante 450
dimasiktuta: posts the ante 450
D.Leonoff: posts the ante 450
ValeraB96: posts the ante 450
phpro: posts the ante 450
7SkYy: posts the ante 450
bullen1414: posts the ante 450
McLci: posts the ante 450
oldyellowbricks: posts small blind 1800
dimasiktuta: posts big blind 3600
*** HOLE CARDS ***
Dealt to phpro [Th Ad]
D.Leonoff: raises 3960 to 7560
ValeraB96: folds
phpro: raises 10375 to 17935 and is all-in
7SkYy: folds
bullen1414: folds
McLci: folds
oldyellowbricks: folds
dimasiktuta: folds
D.Leonoff: calls 10375
*** FLOP *** [Qh Ks Ac]
*** TURN *** [Qh Ks Ac] [7h]
*** RIVER *** [Qh Ks Ac 7h] [3d]
*** SHOW DOWN ***
D.Leonoff: shows [Ts As] (a pair of Aces)
phpro: shows [Th Ad] (a pair of Aces)
D.Leonoff collected 22435 from pot
phpro collected 22435 from pot
*** SUMMARY ***
Total pot 44870 | Rake 0
Board [Qh Ks Ac 7h 3d]
Seat 1: oldyellowbricks (small blind) folded before Flop
Seat 2: dimasiktuta (big blind) folded before Flop
Seat 4: D.Leonoff showed [Ts As] and won (22435) with a pair of Aces
Seat 5: ValeraB96 folded before Flop (didn't bet)
Seat 6: phpro showed [Th Ad] and won (22435) with a pair of Aces
Seat 7: 7SkYy folded before Flop (didn't bet)
Seat 8: bullen1414 folded before Flop (didn't bet)
Seat 9: McLci (button) folded before Flop (didn't bet)


*********** # 279 **************
PokerStars Hand #257048198633: Tournament #3910307458, $0.98+$0.12 USD Hold'em No Limit - Level XXVI (1800/3600) - 2025/07/22 14:01:32 ET
Table '3910307458 12' 9-max Seat #1 is the button
Seat 1: oldyellowbricks (148636 in chips)
Seat 2: dimasiktuta (157491 in chips)
Seat 4: D.Leonoff (119857 in chips)
Seat 5: ValeraB96 (119754 in chips)
Seat 6: phpro (22435 in chips)
Seat 7: 7SkYy (79437 in chips)
Seat 8: bullen1414 (121465 in chips)
Seat 9: McLci (94925 in chips)
oldyellowbricks: posts the ante 450
dimasiktuta: posts the ante 450
D.Leonoff: posts the ante 450
ValeraB96: posts the ante 450
phpro: posts the ante 450
7SkYy: posts the ante 450
bullen1414: posts the ante 450
McLci: posts the ante 450
dimasiktuta: posts small blind 1800
D.Leonoff: posts big blind 3600
*** HOLE CARDS ***
Dealt to phpro [5s 7h]
ValeraB96: folds
phpro: folds
7SkYy: raises 3600 to 7200
bullen1414: folds
McLci: folds
oldyellowbricks: raises 10080 to 17280
dimasiktuta: folds
D.Leonoff: folds
7SkYy: raises 61707 to 78987 and is all-in
oldyellowbricks: folds
Uncalled bet (61707) returned to 7SkYy
7SkYy collected 43560 from pot
7SkYy: doesn't show hand
*** SUMMARY ***
Total pot 43560 | Rake 0
Seat 1: oldyellowbricks (button) folded before Flop
Seat 2: dimasiktuta (small blind) folded before Flop
Seat 4: D.Leonoff (big blind) folded before Flop
Seat 5: ValeraB96 folded before Flop (didn't bet)
Seat 6: phpro folded before Flop (didn't bet)
Seat 7: 7SkYy collected (43560)
Seat 8: bullen1414 folded before Flop (didn't bet)
Seat 9: McLci folded before Flop (didn't bet)


*********** # 280 **************
PokerStars Hand #257048207250: Tournament #3910307458, $0.98+$0.12 USD Hold'em No Limit - Level XXVI (1800/3600) - 2025/07/22 14:02:18 ET
Table '3910307458 12' 9-max Seat #2 is the button
Seat 1: oldyellowbricks (130906 in chips)
Seat 2: dimasiktuta (155241 in chips)
Seat 4: D.Leonoff (115807 in chips)
Seat 5: ValeraB96 (119304 in chips)
Seat 6: phpro (21985 in chips)
Seat 7: 7SkYy (105267 in chips)
Seat 8: bullen1414 (121015 in chips)
Seat 9: McLci (94475 in chips)
oldyellowbricks: posts the ante 450
dimasiktuta: posts the ante 450
D.Leonoff: posts the ante 450
ValeraB96: posts the ante 450
phpro: posts the ante 450
7SkYy: posts the ante 450
bullen1414: posts the ante 450
McLci: posts the ante 450
D.Leonoff: posts small blind 1800
ValeraB96: posts big blind 3600
*** HOLE CARDS ***
Dealt to phpro [As 6d]
phpro: raises 17935 to 21535 and is all-in
7SkYy: folds
bullen1414: folds
McLci: folds
oldyellowbricks: folds
dimasiktuta: folds
D.Leonoff: folds
ValeraB96: folds
Uncalled bet (17935) returned to phpro
phpro collected 12600 from pot
phpro: doesn't show hand
*** SUMMARY ***
Total pot 12600 | Rake 0
Seat 1: oldyellowbricks folded before Flop (didn't bet)
Seat 2: dimasiktuta (button) folded before Flop (didn't bet)
Seat 4: D.Leonoff (small blind) folded before Flop
Seat 5: ValeraB96 (big blind) folded before Flop
Seat 6: phpro collected (12600)
Seat 7: 7SkYy folded before Flop (didn't bet)
Seat 8: bullen1414 folded before Flop (didn't bet)
Seat 9: McLci folded before Flop (didn't bet)


*********** # 281 **************
PokerStars Hand #257048210839: Tournament #3910307458, $0.98+$0.12 USD Hold'em No Limit - Level XXVI (1800/3600) - 2025/07/22 14:02:36 ET
Table '3910307458 12' 9-max Seat #4 is the button
Seat 1: oldyellowbricks (130456 in chips)
Seat 2: dimasiktuta (154791 in chips)
Seat 4: D.Leonoff (113557 in chips)
Seat 5: ValeraB96 (115254 in chips)
Seat 6: phpro (30535 in chips)
Seat 7: 7SkYy (104817 in chips)
Seat 8: bullen1414 (120565 in chips)
Seat 9: McLci (94025 in chips)
oldyellowbricks: posts the ante 450
dimasiktuta: posts the ante 450
D.Leonoff: posts the ante 450
ValeraB96: posts the ante 450
phpro: posts the ante 450
7SkYy: posts the ante 450
bullen1414: posts the ante 450
McLci: posts the ante 450
ValeraB96: posts small blind 1800
phpro: posts big blind 3600
*** HOLE CARDS ***
Dealt to phpro [7s 2d]
7SkYy: folds
bullen1414: raises 3960 to 7560
McLci: folds
oldyellowbricks: folds
dimasiktuta: folds
D.Leonoff: folds
ValeraB96: folds
phpro: folds
Uncalled bet (3960) returned to bullen1414
bullen1414 collected 12600 from pot
bullen1414: doesn't show hand
*** SUMMARY ***
Total pot 12600 | Rake 0
Seat 1: oldyellowbricks folded before Flop (didn't bet)
Seat 2: dimasiktuta folded before Flop (didn't bet)
Seat 4: D.Leonoff (button) folded before Flop (didn't bet)
Seat 5: ValeraB96 (small blind) folded before Flop
Seat 6: phpro (big blind) folded before Flop
Seat 7: 7SkYy folded before Flop (didn't bet)
Seat 8: bullen1414 collected (12600)
Seat 9: McLci folded before Flop (didn't bet)


*********** # 282 **************
PokerStars Hand #257048218771: Tournament #3910307458, $0.98+$0.12 USD Hold'em No Limit - Level XXVI (1800/3600) - 2025/07/22 14:03:16 ET
Table '3910307458 12' 9-max Seat #5 is the button
Seat 1: oldyellowbricks (130006 in chips)
Seat 2: dimasiktuta (154341 in chips)
Seat 4: D.Leonoff (113107 in chips)
Seat 5: ValeraB96 (113004 in chips)
Seat 6: phpro (26485 in chips)
Seat 7: 7SkYy (104367 in chips)
Seat 8: bullen1414 (129115 in chips)
Seat 9: McLci (93575 in chips)
oldyellowbricks: posts the ante 450
dimasiktuta: posts the ante 450
D.Leonoff: posts the ante 450
ValeraB96: posts the ante 450
phpro: posts the ante 450
7SkYy: posts the ante 450
bullen1414: posts the ante 450
McLci: posts the ante 450
phpro: posts small blind 1800
7SkYy: posts big blind 3600
*** HOLE CARDS ***
Dealt to phpro [4d 4c]
bullen1414: folds
McLci: folds
oldyellowbricks: folds
dimasiktuta: raises 3600 to 7200
D.Leonoff: calls 7200
ValeraB96: folds
phpro: folds
7SkYy: folds
*** FLOP *** [3c As Ac]
dimasiktuta: checks
D.Leonoff: checks
*** TURN *** [3c As Ac] [Ad]
dimasiktuta: checks
D.Leonoff: bets 7722
dimasiktuta: raises 13878 to 21600
D.Leonoff: folds
Uncalled bet (13878) returned to dimasiktuta
dimasiktuta collected 38844 from pot
dimasiktuta: doesn't show hand
*** SUMMARY ***
Total pot 38844 | Rake 0
Board [3c As Ac Ad]
Seat 1: oldyellowbricks folded before Flop (didn't bet)
Seat 2: dimasiktuta collected (38844)
Seat 4: D.Leonoff folded on the Turn
Seat 5: ValeraB96 (button) folded before Flop (didn't bet)
Seat 6: phpro (small blind) folded before Flop
Seat 7: 7SkYy (big blind) folded before Flop
Seat 8: bullen1414 folded before Flop (didn't bet)
Seat 9: McLci folded before Flop (didn't bet)


*********** # 283 **************
PokerStars Hand #257048233292: Tournament #3910307458, $0.98+$0.12 USD Hold'em No Limit - Level XXVI (1800/3600) - 2025/07/22 14:04:29 ET
Table '3910307458 12' 9-max Seat #6 is the button
Seat 1: oldyellowbricks (129556 in chips)
Seat 2: dimasiktuta (177813 in chips)
Seat 4: D.Leonoff (97735 in chips)
Seat 5: ValeraB96 (112554 in chips)
Seat 6: phpro (24235 in chips)
Seat 7: 7SkYy (100317 in chips)
Seat 8: bullen1414 (128665 in chips)
Seat 9: McLci (93125 in chips)
oldyellowbricks: posts the ante 450
dimasiktuta: posts the ante 450
D.Leonoff: posts the ante 450
ValeraB96: posts the ante 450
phpro: posts the ante 450
7SkYy: posts the ante 450
bullen1414: posts the ante 450
McLci: posts the ante 450
7SkYy: posts small blind 1800
bullen1414: posts big blind 3600
*** HOLE CARDS ***
Dealt to phpro [Ks Ah]
McLci: folds
oldyellowbricks: folds
dimasiktuta: folds
D.Leonoff: folds
ValeraB96: folds
phpro: raises 20185 to 23785 and is all-in
7SkYy: folds
bullen1414: folds
Uncalled bet (20185) returned to phpro
phpro collected 12600 from pot
phpro: doesn't show hand
*** SUMMARY ***
Total pot 12600 | Rake 0
Seat 1: oldyellowbricks folded before Flop (didn't bet)
Seat 2: dimasiktuta folded before Flop (didn't bet)
Seat 4: D.Leonoff folded before Flop (didn't bet)
Seat 5: ValeraB96 folded before Flop (didn't bet)
Seat 6: phpro (button) collected (12600)
Seat 7: 7SkYy (small blind) folded before Flop
Seat 8: bullen1414 (big blind) folded before Flop
Seat 9: McLci folded before Flop (didn't bet)


*********** # 284 **************
PokerStars Hand #257048237545: Tournament #3910307458, $0.98+$0.12 USD Hold'em No Limit - Level XXVI (1800/3600) - 2025/07/22 14:04:50 ET
Table '3910307458 12' 9-max Seat #7 is the button
Seat 1: oldyellowbricks (129106 in chips)
Seat 2: dimasiktuta (177363 in chips)
Seat 4: D.Leonoff (97285 in chips)
Seat 5: ValeraB96 (112104 in chips)
Seat 6: phpro (32785 in chips)
Seat 7: 7SkYy (98067 in chips)
Seat 8: bullen1414 (124615 in chips)
Seat 9: McLci (92675 in chips)
oldyellowbricks: posts the ante 450
dimasiktuta: posts the ante 450
D.Leonoff: posts the ante 450
ValeraB96: posts the ante 450
phpro: posts the ante 450
7SkYy: posts the ante 450
bullen1414: posts the ante 450
McLci: posts the ante 450
bullen1414: posts small blind 1800
McLci: posts big blind 3600
*** HOLE CARDS ***
Dealt to phpro [Th 2h]
oldyellowbricks: folds
dimasiktuta: raises 3600 to 7200
D.Leonoff: folds
ValeraB96: folds
phpro: folds
7SkYy: folds
bullen1414: folds
McLci: folds
Uncalled bet (3600) returned to dimasiktuta
dimasiktuta collected 12600 from pot
dimasiktuta: doesn't show hand
*** SUMMARY ***
Total pot 12600 | Rake 0
Seat 1: oldyellowbricks folded before Flop (didn't bet)
Seat 2: dimasiktuta collected (12600)
Seat 4: D.Leonoff folded before Flop (didn't bet)
Seat 5: ValeraB96 folded before Flop (didn't bet)
Seat 6: phpro folded before Flop (didn't bet)
Seat 7: 7SkYy (button) folded before Flop (didn't bet)
Seat 8: bullen1414 (small blind) folded before Flop
Seat 9: McLci (big blind) folded before Flop


*********** # 285 **************
PokerStars Hand #257048243245: Tournament #3910307458, $0.98+$0.12 USD Hold'em No Limit - Level XXVII (2000/4000) - 2025/07/22 14:05:18 ET
Table '3910307458 12' 9-max Seat #8 is the button
Seat 1: oldyellowbricks (128656 in chips)
Seat 2: dimasiktuta (185913 in chips)
Seat 4: D.Leonoff (96835 in chips)
Seat 5: ValeraB96 (111654 in chips)
Seat 6: phpro (32335 in chips)
Seat 7: 7SkYy (97617 in chips)
Seat 8: bullen1414 (122365 in chips)
Seat 9: McLci (88625 in chips)
oldyellowbricks: posts the ante 500
dimasiktuta: posts the ante 500
D.Leonoff: posts the ante 500
ValeraB96: posts the ante 500
phpro: posts the ante 500
7SkYy: posts the ante 500
bullen1414: posts the ante 500
McLci: posts the ante 500
McLci: posts small blind 2000
oldyellowbricks: posts big blind 4000
*** HOLE CARDS ***
Dealt to phpro [Qh Kd]
dimasiktuta: folds
D.Leonoff: folds
ValeraB96: folds
phpro: raises 27835 to 31835 and is all-in
7SkYy: folds
bullen1414: folds
McLci: folds
oldyellowbricks: folds
Uncalled bet (27835) returned to phpro
phpro collected 14000 from pot
phpro: doesn't show hand
*** SUMMARY ***
Total pot 14000 | Rake 0
Seat 1: oldyellowbricks (big blind) folded before Flop
Seat 2: dimasiktuta folded before Flop (didn't bet)
Seat 4: D.Leonoff folded before Flop (didn't bet)
Seat 5: ValeraB96 folded before Flop (didn't bet)
Seat 6: phpro collected (14000)
Seat 7: 7SkYy folded before Flop (didn't bet)
Seat 8: bullen1414 (button) folded before Flop (didn't bet)
Seat 9: McLci (small blind) folded before Flop


*********** # 286 **************
PokerStars Hand #257048248966: Tournament #3910307458, $0.98+$0.12 USD Hold'em No Limit - Level XXVII (2000/4000) - 2025/07/22 14:05:47 ET
Table '3910307458 12' 9-max Seat #9 is the button
Seat 1: oldyellowbricks (124156 in chips)
Seat 2: dimasiktuta (185413 in chips)
Seat 4: D.Leonoff (96335 in chips)
Seat 5: ValeraB96 (111154 in chips)
Seat 6: phpro (41835 in chips)
Seat 7: 7SkYy (97117 in chips)
Seat 8: bullen1414 (121865 in chips)
Seat 9: McLci (86125 in chips)
oldyellowbricks: posts the ante 500
dimasiktuta: posts the ante 500
D.Leonoff: posts the ante 500
ValeraB96: posts the ante 500
phpro: posts the ante 500
7SkYy: posts the ante 500
bullen1414: posts the ante 500
McLci: posts the ante 500
oldyellowbricks: posts small blind 2000
dimasiktuta: posts big blind 4000
*** HOLE CARDS ***
Dealt to phpro [2d Qh]
D.Leonoff: raises 4400 to 8400
ValeraB96: folds
phpro: folds
7SkYy: folds
bullen1414: folds
McLci: folds
oldyellowbricks: folds
dimasiktuta: folds
Uncalled bet (4400) returned to D.Leonoff
D.Leonoff collected 14000 from pot
D.Leonoff: doesn't show hand
*** SUMMARY ***
Total pot 14000 | Rake 0
Seat 1: oldyellowbricks (small blind) folded before Flop
Seat 2: dimasiktuta (big blind) folded before Flop
Seat 4: D.Leonoff collected (14000)
Seat 5: ValeraB96 folded before Flop (didn't bet)
Seat 6: phpro folded before Flop (didn't bet)
Seat 7: 7SkYy folded before Flop (didn't bet)
Seat 8: bullen1414 folded before Flop (didn't bet)
Seat 9: McLci (button) folded before Flop (didn't bet)


*********** # 287 **************
PokerStars Hand #257048254462: Tournament #3910307458, $0.98+$0.12 USD Hold'em No Limit - Level XXVII (2000/4000) - 2025/07/22 14:06:14 ET
Table '3910307458 12' 9-max Seat #1 is the button
Seat 1: oldyellowbricks (121656 in chips)
Seat 2: dimasiktuta (180913 in chips)
Seat 4: D.Leonoff (105835 in chips)
Seat 5: ValeraB96 (110654 in chips)
Seat 6: phpro (41335 in chips)
Seat 7: 7SkYy (96617 in chips)
Seat 8: bullen1414 (121365 in chips)
Seat 9: McLci (85625 in chips)
oldyellowbricks: posts the ante 500
dimasiktuta: posts the ante 500
D.Leonoff: posts the ante 500
ValeraB96: posts the ante 500
phpro: posts the ante 500
7SkYy: posts the ante 500
bullen1414: posts the ante 500
McLci: posts the ante 500
dimasiktuta: posts small blind 2000
D.Leonoff: posts big blind 4000
*** HOLE CARDS ***
Dealt to phpro [Ad 7c]
ValeraB96: folds
phpro: folds
7SkYy: folds
bullen1414: folds
McLci: raises 4000 to 8000
oldyellowbricks: calls 8000
dimasiktuta: folds
D.Leonoff: calls 4000
*** FLOP *** [Jd 3d Qc]
D.Leonoff: checks
McLci: bets 8000
oldyellowbricks: calls 8000
D.Leonoff: calls 8000
*** TURN *** [Jd 3d Qc] [Jh]
D.Leonoff: checks
McLci: bets 12000
oldyellowbricks: folds
D.Leonoff: calls 12000
*** RIVER *** [Jd 3d Qc Jh] [2s]
D.Leonoff: checks
McLci: bets 24000
D.Leonoff: calls 24000
*** SHOW DOWN ***
McLci: shows [Td Jc] (three of a kind, Jacks)
D.Leonoff: mucks hand
McLci collected 126000 from pot
*** SUMMARY ***
Total pot 126000 | Rake 0
Board [Jd 3d Qc Jh 2s]
Seat 1: oldyellowbricks (button) folded on the Turn
Seat 2: dimasiktuta (small blind) folded before Flop
Seat 4: D.Leonoff (big blind) mucked [8c Qd]
Seat 5: ValeraB96 folded before Flop (didn't bet)
Seat 6: phpro folded before Flop (didn't bet)
Seat 7: 7SkYy folded before Flop (didn't bet)
Seat 8: bullen1414 folded before Flop (didn't bet)
Seat 9: McLci showed [Td Jc] and won (126000) with three of a kind, Jacks


*********** # 288 **************
PokerStars Hand #257048272260: Tournament #3910307458, $0.98+$0.12 USD Hold'em No Limit - Level XXVII (2000/4000) - 2025/07/22 14:07:43 ET
Table '3910307458 12' 9-max Seat #2 is the button
Seat 1: oldyellowbricks (105156 in chips)
Seat 2: dimasiktuta (178413 in chips)
Seat 4: D.Leonoff (53335 in chips)
Seat 5: ValeraB96 (110154 in chips)
Seat 6: phpro (40835 in chips)
Seat 7: 7SkYy (96117 in chips)
Seat 8: bullen1414 (120865 in chips)
Seat 9: McLci (159125 in chips)
oldyellowbricks: posts the ante 500
dimasiktuta: posts the ante 500
D.Leonoff: posts the ante 500
ValeraB96: posts the ante 500
phpro: posts the ante 500
7SkYy: posts the ante 500
bullen1414: posts the ante 500
McLci: posts the ante 500
D.Leonoff: posts small blind 2000
ValeraB96: posts big blind 4000
*** HOLE CARDS ***
Dealt to phpro [Jd 8d]
phpro is connected
phpro is disconnected
phpro is connected
phpro: folds
7SkYy: folds
bullen1414: folds
McLci: folds
oldyellowbricks: folds
dimasiktuta: raises 4000 to 8000
D.Leonoff: folds
ValeraB96: folds
Uncalled bet (4000) returned to dimasiktuta
dimasiktuta collected 14000 from pot
dimasiktuta: doesn't show hand
*** SUMMARY ***
Total pot 14000 | Rake 0
Seat 1: oldyellowbricks folded before Flop (didn't bet)
Seat 2: dimasiktuta (button) collected (14000)
Seat 4: D.Leonoff (small blind) folded before Flop
Seat 5: ValeraB96 (big blind) folded before Flop
Seat 6: phpro folded before Flop (didn't bet)
Seat 7: 7SkYy folded before Flop (didn't bet)
Seat 8: bullen1414 folded before Flop (didn't bet)
Seat 9: McLci folded before Flop (didn't bet)


*********** # 289 **************
PokerStars Hand #257048287723: Tournament #3910307458, $0.98+$0.12 USD Hold'em No Limit - Level XXVII (2000/4000) - 2025/07/22 14:09:00 ET
Table '3910307458 12' 9-max Seat #4 is the button
Seat 1: oldyellowbricks (104656 in chips)
Seat 2: dimasiktuta (187913 in chips)
Seat 4: D.Leonoff (50835 in chips)
Seat 5: ValeraB96 (105654 in chips)
Seat 6: phpro (40335 in chips)
Seat 7: 7SkYy (95617 in chips)
Seat 8: bullen1414 (120365 in chips)
Seat 9: McLci (158625 in chips)
oldyellowbricks: posts the ante 500
dimasiktuta: posts the ante 500
D.Leonoff: posts the ante 500
ValeraB96: posts the ante 500
phpro: posts the ante 500
7SkYy: posts the ante 500
bullen1414: posts the ante 500
McLci: posts the ante 500
ValeraB96: posts small blind 2000
phpro: posts big blind 4000
*** HOLE CARDS ***
Dealt to phpro [Ah Jd]
7SkYy: folds
bullen1414: folds
McLci: folds
oldyellowbricks: folds
dimasiktuta: folds
D.Leonoff: folds
ValeraB96: raises 100000 to 104000
phpro: calls 35835 and is all-in
Uncalled bet (64165) returned to ValeraB96
*** FLOP *** [4d Qd Jh]
*** TURN *** [4d Qd Jh] [7d]
*** RIVER *** [4d Qd Jh 7d] [Td]
*** SHOW DOWN ***
ValeraB96: shows [Kc 5c] (high card King)
phpro: shows [Ah Jd] (a flush, Queen high)
phpro collected 83670 from pot
*** SUMMARY ***
Total pot 83670 | Rake 0
Board [4d Qd Jh 7d Td]
Seat 1: oldyellowbricks folded before Flop (didn't bet)
Seat 2: dimasiktuta folded before Flop (didn't bet)
Seat 4: D.Leonoff (button) folded before Flop (didn't bet)
Seat 5: ValeraB96 (small blind) showed [Kc 5c] and lost with high card King
Seat 6: phpro (big blind) showed [Ah Jd] and won (83670) with a flush, Queen high
Seat 7: 7SkYy folded before Flop (didn't bet)
Seat 8: bullen1414 folded before Flop (didn't bet)
Seat 9: McLci folded before Flop (didn't bet)


*********** # 290 **************
PokerStars Hand #257048296130: Tournament #3910307458, $0.98+$0.12 USD Hold'em No Limit - Level XXVII (2000/4000) - 2025/07/22 14:09:42 ET
Table '3910307458 12' 9-max Seat #5 is the button
Seat 1: oldyellowbricks (104156 in chips)
Seat 2: dimasiktuta (187413 in chips)
Seat 4: D.Leonoff (50335 in chips)
Seat 5: ValeraB96 (65319 in chips)
Seat 6: phpro (83670 in chips)
Seat 7: 7SkYy (95117 in chips)
Seat 8: bullen1414 (119865 in chips)
Seat 9: McLci (158125 in chips)
oldyellowbricks: posts the ante 500
dimasiktuta: posts the ante 500
D.Leonoff: posts the ante 500
ValeraB96: posts the ante 500
phpro: posts the ante 500
7SkYy: posts the ante 500
bullen1414: posts the ante 500
McLci: posts the ante 500
phpro: posts small blind 2000
7SkYy: posts big blind 4000
*** HOLE CARDS ***
Dealt to phpro [7d Qh]
bullen1414: folds
McLci: folds
oldyellowbricks: folds
dimasiktuta: raises 4000 to 8000
D.Leonoff: folds
ValeraB96: folds
phpro: folds
7SkYy: folds
Uncalled bet (4000) returned to dimasiktuta
dimasiktuta collected 14000 from pot
dimasiktuta: doesn't show hand
*** SUMMARY ***
Total pot 14000 | Rake 0
Seat 1: oldyellowbricks folded before Flop (didn't bet)
Seat 2: dimasiktuta collected (14000)
Seat 4: D.Leonoff folded before Flop (didn't bet)
Seat 5: ValeraB96 (button) folded before Flop (didn't bet)
Seat 6: phpro (small blind) folded before Flop
Seat 7: 7SkYy (big blind) folded before Flop
Seat 8: bullen1414 folded before Flop (didn't bet)
Seat 9: McLci folded before Flop (didn't bet)


*********** # 291 **************
PokerStars Hand #257048301801: Tournament #3910307458, $0.98+$0.12 USD Hold'em No Limit - Level XXVII (2000/4000) - 2025/07/22 14:10:10 ET
Table '3910307458 12' 9-max Seat #6 is the button
Seat 1: oldyellowbricks (103656 in chips)
Seat 2: dimasiktuta (196913 in chips)
Seat 4: D.Leonoff (49835 in chips)
Seat 5: ValeraB96 (64819 in chips)
Seat 6: phpro (81170 in chips)
Seat 7: 7SkYy (90617 in chips)
Seat 8: bullen1414 (119365 in chips)
Seat 9: McLci (157625 in chips)
oldyellowbricks: posts the ante 500
dimasiktuta: posts the ante 500
D.Leonoff: posts the ante 500
ValeraB96: posts the ante 500
phpro: posts the ante 500
7SkYy: posts the ante 500
bullen1414: posts the ante 500
McLci: posts the ante 500
7SkYy: posts small blind 2000
bullen1414: posts big blind 4000
*** HOLE CARDS ***
Dealt to phpro [Th 2h]
McLci: folds
oldyellowbricks: folds
dimasiktuta: folds
D.Leonoff: folds
ValeraB96: raises 4000 to 8000
phpro: folds
phpro is disconnected
7SkYy: folds
bullen1414: folds
Uncalled bet (4000) returned to ValeraB96
ValeraB96 collected 14000 from pot
ValeraB96: doesn't show hand
*** SUMMARY ***
Total pot 14000 | Rake 0
Seat 1: oldyellowbricks folded before Flop (didn't bet)
Seat 2: dimasiktuta folded before Flop (didn't bet)
Seat 4: D.Leonoff folded before Flop (didn't bet)
Seat 5: ValeraB96 collected (14000)
Seat 6: phpro (button) folded before Flop (didn't bet)
Seat 7: 7SkYy (small blind) folded before Flop
Seat 8: bullen1414 (big blind) folded before Flop
Seat 9: McLci folded before Flop (didn't bet)


*********** # 292 **************
PokerStars Hand #257048312325: Tournament #3910307458, $0.98+$0.12 USD Hold'em No Limit - Level XXVII (2000/4000) - 2025/07/22 14:11:02 ET
Table '3910307458 12' 9-max Seat #7 is the button
Seat 1: oldyellowbricks (103156 in chips)
Seat 2: dimasiktuta (196413 in chips)
Seat 4: D.Leonoff (49335 in chips)
Seat 5: ValeraB96 (74319 in chips)
Seat 6: phpro (80670 in chips)
Seat 7: 7SkYy (88117 in chips)
Seat 8: bullen1414 (114865 in chips)
Seat 9: McLci (157125 in chips)
oldyellowbricks: posts the ante 500
dimasiktuta: posts the ante 500
D.Leonoff: posts the ante 500
ValeraB96: posts the ante 500
phpro: posts the ante 500
7SkYy: posts the ante 500
bullen1414: posts the ante 500
McLci: posts the ante 500
bullen1414: posts small blind 2000
McLci: posts big blind 4000
*** HOLE CARDS ***
Dealt to phpro [9s 6d]
oldyellowbricks: folds
dimasiktuta: folds
D.Leonoff: raises 4000 to 8000
phpro is disconnected
ValeraB96: folds
phpro is connected
phpro: folds
7SkYy: folds
bullen1414: folds
McLci: calls 4000
*** FLOP *** [Jc 7s Ks]
McLci: checks
D.Leonoff: bets 7260
McLci: folds
Uncalled bet (7260) returned to D.Leonoff
D.Leonoff collected 22000 from pot
D.Leonoff: doesn't show hand
*** SUMMARY ***
Total pot 22000 | Rake 0
Board [Jc 7s Ks]
Seat 1: oldyellowbricks folded before Flop (didn't bet)
Seat 2: dimasiktuta folded before Flop (didn't bet)
Seat 4: D.Leonoff collected (22000)
Seat 5: ValeraB96 folded before Flop (didn't bet)
Seat 6: phpro folded before Flop (didn't bet)
Seat 7: 7SkYy (button) folded before Flop (didn't bet)
Seat 8: bullen1414 (small blind) folded before Flop
Seat 9: McLci (big blind) folded on the Flop


*********** # 293 **************
PokerStars Hand #257048322199: Tournament #3910307458, $0.98+$0.12 USD Hold'em No Limit - Level XXVII (2000/4000) - 2025/07/22 14:11:52 ET
Table '3910307458 12' 9-max Seat #8 is the button
Seat 1: oldyellowbricks (102656 in chips)
Seat 2: dimasiktuta (195913 in chips)
Seat 4: D.Leonoff (62835 in chips)
Seat 5: ValeraB96 (73819 in chips)
Seat 6: phpro (80170 in chips)
Seat 7: 7SkYy (87617 in chips)
Seat 8: bullen1414 (112365 in chips)
Seat 9: McLci (148625 in chips)
oldyellowbricks: posts the ante 500
dimasiktuta: posts the ante 500
D.Leonoff: posts the ante 500
ValeraB96: posts the ante 500
phpro: posts the ante 500
7SkYy: posts the ante 500
bullen1414: posts the ante 500
McLci: posts the ante 500
McLci: posts small blind 2000
oldyellowbricks: posts big blind 4000
*** HOLE CARDS ***
Dealt to phpro [Td Th]
dimasiktuta: raises 4000 to 8000
D.Leonoff: folds
ValeraB96: folds
phpro: calls 8000
7SkYy: folds
bullen1414: folds
McLci: raises 16000 to 24000
oldyellowbricks: folds
dimasiktuta: folds
phpro: folds
Uncalled bet (16000) returned to McLci
McLci collected 32000 from pot
McLci: doesn't show hand
*** SUMMARY ***
Total pot 32000 | Rake 0
Seat 1: oldyellowbricks (big blind) folded before Flop
Seat 2: dimasiktuta folded before Flop
Seat 4: D.Leonoff folded before Flop (didn't bet)
Seat 5: ValeraB96 folded before Flop (didn't bet)
Seat 6: phpro folded before Flop
Seat 7: 7SkYy folded before Flop (didn't bet)
Seat 8: bullen1414 (button) folded before Flop (didn't bet)
Seat 9: McLci (small blind) collected (32000)


*********** # 294 **************
PokerStars Hand #257048331788: Tournament #3910307458, $0.98+$0.12 USD Hold'em No Limit - Level XXVII (2000/4000) - 2025/07/22 14:12:39 ET
Table '3910307458 12' 9-max Seat #9 is the button
Seat 1: oldyellowbricks (98156 in chips)
Seat 2: dimasiktuta (187413 in chips)
Seat 4: D.Leonoff (62335 in chips)
Seat 5: ValeraB96 (73319 in chips)
Seat 6: phpro (71670 in chips)
Seat 7: 7SkYy (87117 in chips)
Seat 8: bullen1414 (111865 in chips)
Seat 9: McLci (172125 in chips)
oldyellowbricks: posts the ante 500
dimasiktuta: posts the ante 500
D.Leonoff: posts the ante 500
ValeraB96: posts the ante 500
phpro: posts the ante 500
7SkYy: posts the ante 500
bullen1414: posts the ante 500
McLci: posts the ante 500
oldyellowbricks: posts small blind 2000
dimasiktuta: posts big blind 4000
*** HOLE CARDS ***
Dealt to phpro [7d Jd]
D.Leonoff: folds
ValeraB96: folds
phpro: folds
7SkYy: folds
bullen1414: folds
McLci: raises 4000 to 8000
oldyellowbricks: folds
dimasiktuta: calls 4000
*** FLOP *** [9h Ac 5h]
dimasiktuta: checks
McLci: bets 11000
dimasiktuta: folds
Uncalled bet (11000) returned to McLci
McLci collected 22000 from pot
McLci: doesn't show hand
*** SUMMARY ***
Total pot 22000 | Rake 0
Board [9h Ac 5h]
Seat 1: oldyellowbricks (small blind) folded before Flop
Seat 2: dimasiktuta (big blind) folded on the Flop
Seat 4: D.Leonoff folded before Flop (didn't bet)
Seat 5: ValeraB96 folded before Flop (didn't bet)
Seat 6: phpro folded before Flop (didn't bet)
Seat 7: 7SkYy folded before Flop (didn't bet)
Seat 8: bullen1414 folded before Flop (didn't bet)
Seat 9: McLci (button) collected (22000)


*********** # 295 **************
PokerStars Hand #257048341487: Tournament #3910307458, $0.98+$0.12 USD Hold'em No Limit - Level XXVII (2000/4000) - 2025/07/22 14:13:27 ET
Table '3910307458 12' 9-max Seat #1 is the button
Seat 1: oldyellowbricks (95656 in chips)
Seat 2: dimasiktuta (178913 in chips)
Seat 4: D.Leonoff (61835 in chips)
Seat 5: ValeraB96 (72819 in chips)
Seat 6: phpro (71170 in chips)
Seat 7: 7SkYy (86617 in chips)
Seat 8: bullen1414 (111365 in chips)
Seat 9: McLci (185625 in chips)
oldyellowbricks: posts the ante 500
dimasiktuta: posts the ante 500
D.Leonoff: posts the ante 500
ValeraB96: posts the ante 500
phpro: posts the ante 500
7SkYy: posts the ante 500
bullen1414: posts the ante 500
McLci: posts the ante 500
dimasiktuta: posts small blind 2000
D.Leonoff: posts big blind 4000
*** HOLE CARDS ***
Dealt to phpro [2d Ks]
ValeraB96: folds
phpro: folds
7SkYy: folds
bullen1414: folds
McLci: folds
oldyellowbricks: folds
dimasiktuta: raises 8000 to 12000
D.Leonoff: folds
Uncalled bet (8000) returned to dimasiktuta
dimasiktuta collected 12000 from pot
dimasiktuta: doesn't show hand
*** SUMMARY ***
Total pot 12000 | Rake 0
Seat 1: oldyellowbricks (button) folded before Flop (didn't bet)
Seat 2: dimasiktuta (small blind) collected (12000)
Seat 4: D.Leonoff (big blind) folded before Flop
Seat 5: ValeraB96 folded before Flop (didn't bet)
Seat 6: phpro folded before Flop (didn't bet)
Seat 7: 7SkYy folded before Flop (didn't bet)
Seat 8: bullen1414 folded before Flop (didn't bet)
Seat 9: McLci folded before Flop (didn't bet)


*********** # 296 **************
PokerStars Hand #257048348931: Tournament #3910307458, $0.98+$0.12 USD Hold'em No Limit - Level XXVII (2000/4000) - 2025/07/22 14:14:04 ET
Table '3910307458 12' 9-max Seat #2 is the button
Seat 1: oldyellowbricks (95156 in chips)
Seat 2: dimasiktuta (186413 in chips)
Seat 4: D.Leonoff (57335 in chips)
Seat 5: ValeraB96 (72319 in chips)
Seat 6: phpro (70670 in chips)
Seat 7: 7SkYy (86117 in chips)
Seat 8: bullen1414 (110865 in chips)
Seat 9: McLci (185125 in chips)
oldyellowbricks: posts the ante 500
dimasiktuta: posts the ante 500
D.Leonoff: posts the ante 500
ValeraB96: posts the ante 500
phpro: posts the ante 500
7SkYy: posts the ante 500
bullen1414: posts the ante 500
McLci: posts the ante 500
D.Leonoff: posts small blind 2000
ValeraB96: posts big blind 4000
*** HOLE CARDS ***
Dealt to phpro [Kd Td]
phpro: raises 4000 to 8000
7SkYy: folds
bullen1414: folds
McLci: folds
oldyellowbricks: folds
dimasiktuta: folds
D.Leonoff: calls 6000
ValeraB96: folds
*** FLOP *** [2h 4c Ts]
D.Leonoff: checks
phpro: bets 12000
D.Leonoff: raises 36835 to 48835 and is all-in
phpro: calls 36835
*** TURN *** [2h 4c Ts] [Kc]
*** RIVER *** [2h 4c Ts Kc] [5c]
*** SHOW DOWN ***
D.Leonoff: shows [Qh Th] (a pair of Tens)
phpro: shows [Kd Td] (two pair, Kings and Tens)
phpro collected 121670 from pot
D.Leonoff finished the tournament in 8th place and received $7.85.
*** SUMMARY ***
Total pot 121670 | Rake 0
Board [2h 4c Ts Kc 5c]
Seat 1: oldyellowbricks folded before Flop (didn't bet)
Seat 2: dimasiktuta (button) folded before Flop (didn't bet)
Seat 4: D.Leonoff (small blind) showed [Qh Th] and lost with a pair of Tens
Seat 5: ValeraB96 (big blind) folded before Flop
Seat 6: phpro showed [Kd Td] and won (121670) with two pair, Kings and Tens
Seat 7: 7SkYy folded before Flop (didn't bet)
Seat 8: bullen1414 folded before Flop (didn't bet)
Seat 9: McLci folded before Flop (didn't bet)


*********** # 297 **************
PokerStars Hand #257048358947: Tournament #3910307458, $0.98+$0.12 USD Hold'em No Limit - Level XXVII (2000/4000) - 2025/07/22 14:14:53 ET
Table '3910307458 12' 9-max Seat #5 is the button
Seat 1: oldyellowbricks (94656 in chips)
Seat 2: dimasiktuta (185913 in chips)
Seat 5: ValeraB96 (67819 in chips)
Seat 6: phpro (135005 in chips)
Seat 7: 7SkYy (85617 in chips)
Seat 8: bullen1414 (110365 in chips)
Seat 9: McLci (184625 in chips)
oldyellowbricks: posts the ante 500
dimasiktuta: posts the ante 500
ValeraB96: posts the ante 500
phpro: posts the ante 500
7SkYy: posts the ante 500
bullen1414: posts the ante 500
McLci: posts the ante 500
phpro: posts small blind 2000
7SkYy: posts big blind 4000
*** HOLE CARDS ***
Dealt to phpro [2c Ac]
bullen1414: folds
McLci: folds
oldyellowbricks: raises 4000 to 8000
dimasiktuta: calls 8000
ValeraB96: folds
phpro: folds
7SkYy: folds
*** FLOP *** [Th 6d 5s]
oldyellowbricks: checks
dimasiktuta: checks
*** TURN *** [Th 6d 5s] [Ad]
oldyellowbricks: checks
dimasiktuta: bets 6120
oldyellowbricks: calls 6120
*** RIVER *** [Th 6d 5s Ad] [Ts]
oldyellowbricks: checks
dimasiktuta: checks
*** SHOW DOWN ***
oldyellowbricks: shows [Tc Kd] (three of a kind, Tens)
dimasiktuta: mucks hand
oldyellowbricks collected 37740 from pot
*** SUMMARY ***
Total pot 37740 | Rake 0
Board [Th 6d 5s Ad Ts]
Seat 1: oldyellowbricks showed [Tc Kd] and won (37740) with three of a kind, Tens
Seat 2: dimasiktuta mucked [Ks Jc]
Seat 5: ValeraB96 (button) folded before Flop (didn't bet)
Seat 6: phpro (small blind) folded before Flop
Seat 7: 7SkYy (big blind) folded before Flop
Seat 8: bullen1414 folded before Flop (didn't bet)
Seat 9: McLci folded before Flop (didn't bet)


*********** # 298 **************
PokerStars Hand #257048370142: Tournament #3910307458, $0.98+$0.12 USD Hold'em No Limit - Level XXVIII (2400/4800) - 2025/07/22 14:15:47 ET
Table '3910307458 12' 9-max Seat #6 is the button
Seat 1: oldyellowbricks (117776 in chips)
Seat 2: dimasiktuta (171293 in chips)
Seat 5: ValeraB96 (67319 in chips)
Seat 6: phpro (132505 in chips)
Seat 7: 7SkYy (81117 in chips)
Seat 8: bullen1414 (109865 in chips)
Seat 9: McLci (184125 in chips)
oldyellowbricks: posts the ante 600
dimasiktuta: posts the ante 600
ValeraB96: posts the ante 600
phpro: posts the ante 600
7SkYy: posts the ante 600
bullen1414: posts the ante 600
McLci: posts the ante 600
7SkYy: posts small blind 2400
bullen1414: posts big blind 4800
*** HOLE CARDS ***
Dealt to phpro [Th Jc]
McLci: folds
oldyellowbricks: folds
dimasiktuta: raises 4800 to 9600
ValeraB96: raises 57119 to 66719 and is all-in
phpro: folds
7SkYy: folds
bullen1414: folds
dimasiktuta: folds
Uncalled bet (57119) returned to ValeraB96
ValeraB96 collected 30600 from pot
ValeraB96: doesn't show hand
*** SUMMARY ***
Total pot 30600 | Rake 0
Seat 1: oldyellowbricks folded before Flop (didn't bet)
Seat 2: dimasiktuta folded before Flop
Seat 5: ValeraB96 collected (30600)
Seat 6: phpro (button) folded before Flop (didn't bet)
Seat 7: 7SkYy (small blind) folded before Flop
Seat 8: bullen1414 (big blind) folded before Flop
Seat 9: McLci folded before Flop (didn't bet)


*********** # 299 **************
PokerStars Hand #257048375245: Tournament #3910307458, $0.98+$0.12 USD Hold'em No Limit - Level XXVIII (2400/4800) - 2025/07/22 14:16:12 ET
Table '3910307458 12' 9-max Seat #7 is the button
Seat 1: oldyellowbricks (117176 in chips)
Seat 2: dimasiktuta (161093 in chips)
Seat 5: ValeraB96 (87719 in chips)
Seat 6: phpro (131905 in chips)
Seat 7: 7SkYy (78117 in chips)
Seat 8: bullen1414 (104465 in chips)
Seat 9: McLci (183525 in chips)
oldyellowbricks: posts the ante 600
dimasiktuta: posts the ante 600
ValeraB96: posts the ante 600
phpro: posts the ante 600
7SkYy: posts the ante 600
bullen1414: posts the ante 600
McLci: posts the ante 600
bullen1414: posts small blind 2400
McLci: posts big blind 4800
*** HOLE CARDS ***
Dealt to phpro [6h Ad]
oldyellowbricks: folds
dimasiktuta: raises 4800 to 9600
ValeraB96: folds
phpro: folds
7SkYy: folds
bullen1414: folds
McLci: folds
Uncalled bet (4800) returned to dimasiktuta
dimasiktuta collected 16200 from pot
dimasiktuta: doesn't show hand
*** SUMMARY ***
Total pot 16200 | Rake 0
Seat 1: oldyellowbricks folded before Flop (didn't bet)
Seat 2: dimasiktuta collected (16200)
Seat 5: ValeraB96 folded before Flop (didn't bet)
Seat 6: phpro folded before Flop (didn't bet)
Seat 7: 7SkYy (button) folded before Flop (didn't bet)
Seat 8: bullen1414 (small blind) folded before Flop
Seat 9: McLci (big blind) folded before Flop


*********** # 300 **************
PokerStars Hand #257048383879: Tournament #3910307458, $0.98+$0.12 USD Hold'em No Limit - Level XXVIII (2400/4800) - 2025/07/22 14:16:54 ET
Table '3910307458 12' 9-max Seat #8 is the button
Seat 1: oldyellowbricks (116576 in chips)
Seat 2: dimasiktuta (171893 in chips)
Seat 5: ValeraB96 (87119 in chips)
Seat 6: phpro (131305 in chips)
Seat 7: 7SkYy (77517 in chips)
Seat 8: bullen1414 (101465 in chips)
Seat 9: McLci (178125 in chips)
oldyellowbricks: posts the ante 600
dimasiktuta: posts the ante 600
ValeraB96: posts the ante 600
phpro: posts the ante 600
7SkYy: posts the ante 600
bullen1414: posts the ante 600
McLci: posts the ante 600
McLci: posts small blind 2400
oldyellowbricks: posts big blind 4800
*** HOLE CARDS ***
Dealt to phpro [3c Kh]
dimasiktuta: folds
ValeraB96: folds
phpro: folds
7SkYy: folds
bullen1414: raises 5280 to 10080
McLci: folds
oldyellowbricks: calls 5280
*** FLOP *** [7d 5h 3s]
oldyellowbricks: bets 8831
bullen1414: calls 8831
*** TURN *** [7d 5h 3s] [4d]
oldyellowbricks: bets 24000
bullen1414: calls 24000
*** RIVER *** [7d 5h 3s 4d] [7h]
oldyellowbricks: bets 73065 and is all-in
bullen1414: calls 57954 and is all-in
Uncalled bet (15111) returned to oldyellowbricks
*** SHOW DOWN ***
oldyellowbricks: shows [9d 2d] (a pair of Sevens)
bullen1414: shows [Ad 6d] (a straight, Three to Seven)
bullen1414 collected 208330 from pot
*** SUMMARY ***
Total pot 208330 | Rake 0
Board [7d 5h 3s 4d 7h]
Seat 1: oldyellowbricks (big blind) showed [9d 2d] and lost with a pair of Sevens
Seat 2: dimasiktuta folded before Flop (didn't bet)
Seat 5: ValeraB96 folded before Flop (didn't bet)
Seat 6: phpro folded before Flop (didn't bet)
Seat 7: 7SkYy folded before Flop (didn't bet)
Seat 8: bullen1414 (button) showed [Ad 6d] and won (208330) with a straight, Three to Seven
Seat 9: McLci (small blind) folded before Flop


*********** # 301 **************
PokerStars Hand #257048400537: Tournament #3910307458, $0.98+$0.12 USD Hold'em No Limit - Level XXVIII (2400/4800) - 2025/07/22 14:18:14 ET
Table '3910307458 12' 9-max Seat #9 is the button
Seat 1: oldyellowbricks (15111 in chips)
Seat 2: dimasiktuta (171293 in chips)
Seat 5: ValeraB96 (86519 in chips)
Seat 6: phpro (130705 in chips)
Seat 7: 7SkYy (76917 in chips)
Seat 8: bullen1414 (208330 in chips)
Seat 9: McLci (175125 in chips)
oldyellowbricks: posts the ante 600
dimasiktuta: posts the ante 600
ValeraB96: posts the ante 600
phpro: posts the ante 600
7SkYy: posts the ante 600
bullen1414: posts the ante 600
McLci: posts the ante 600
oldyellowbricks: posts small blind 2400
dimasiktuta: posts big blind 4800
*** HOLE CARDS ***
Dealt to phpro [3h Qs]
ValeraB96: folds
phpro: folds
7SkYy: folds
bullen1414: folds
McLci: raises 4800 to 9600
oldyellowbricks: folds
dimasiktuta: folds
Uncalled bet (4800) returned to McLci
McLci collected 16200 from pot
McLci: doesn't show hand
*** SUMMARY ***
Total pot 16200 | Rake 0
Seat 1: oldyellowbricks (small blind) folded before Flop
Seat 2: dimasiktuta (big blind) folded before Flop
Seat 5: ValeraB96 folded before Flop (didn't bet)
Seat 6: phpro folded before Flop (didn't bet)
Seat 7: 7SkYy folded before Flop (didn't bet)
Seat 8: bullen1414 folded before Flop (didn't bet)
Seat 9: McLci (button) collected (16200)


*********** # 302 **************
PokerStars Hand #257048406260: Tournament #3910307458, $0.98+$0.12 USD Hold'em No Limit - Level XXVIII (2400/4800) - 2025/07/22 14:18:42 ET
Table '3910307458 12' 9-max Seat #1 is the button
Seat 1: oldyellowbricks (12111 in chips)
Seat 2: dimasiktuta (165893 in chips)
Seat 5: ValeraB96 (85919 in chips)
Seat 6: phpro (130105 in chips)
Seat 7: 7SkYy (76317 in chips)
Seat 8: bullen1414 (207730 in chips)
Seat 9: McLci (185925 in chips)
oldyellowbricks: posts the ante 600
dimasiktuta: posts the ante 600
ValeraB96: posts the ante 600
phpro: posts the ante 600
7SkYy: posts the ante 600
bullen1414: posts the ante 600
McLci: posts the ante 600
dimasiktuta: posts small blind 2400
ValeraB96: posts big blind 4800
*** HOLE CARDS ***
Dealt to phpro [4s Ah]
phpro: folds
7SkYy: folds
bullen1414: folds
McLci: folds
oldyellowbricks: raises 6711 to 11511 and is all-in
dimasiktuta: folds
ValeraB96: calls 6711
*** FLOP *** [8h 3d Jh]
*** TURN *** [8h 3d Jh] [Tc]
*** RIVER *** [8h 3d Jh Tc] [2d]
*** SHOW DOWN ***
ValeraB96: shows [Qd 6h] (high card Queen)
oldyellowbricks: shows [Ts 6s] (a pair of Tens)
oldyellowbricks collected 29622 from pot
*** SUMMARY ***
Total pot 29622 | Rake 0
Board [8h 3d Jh Tc 2d]
Seat 1: oldyellowbricks (button) showed [Ts 6s] and won (29622) with a pair of Tens
Seat 2: dimasiktuta (small blind) folded before Flop
Seat 5: ValeraB96 (big blind) showed [Qd 6h] and lost with high card Queen
Seat 6: phpro folded before Flop (didn't bet)
Seat 7: 7SkYy folded before Flop (didn't bet)
Seat 8: bullen1414 folded before Flop (didn't bet)
Seat 9: McLci folded before Flop (didn't bet)


*********** # 303 **************
PokerStars Hand #257048412058: Tournament #3910307458, $0.98+$0.12 USD Hold'em No Limit - Level XXVIII (2400/4800) - 2025/07/22 14:19:10 ET
Table '3910307458 12' 9-max Seat #2 is the button
Seat 1: oldyellowbricks (29622 in chips)
Seat 2: dimasiktuta (162893 in chips)
Seat 5: ValeraB96 (73808 in chips)
Seat 6: phpro (129505 in chips)
Seat 7: 7SkYy (75717 in chips)
Seat 8: bullen1414 (207130 in chips)
Seat 9: McLci (185325 in chips)
oldyellowbricks: posts the ante 600
dimasiktuta: posts the ante 600
ValeraB96: posts the ante 600
phpro: posts the ante 600
7SkYy: posts the ante 600
bullen1414: posts the ante 600
McLci: posts the ante 600
ValeraB96: posts small blind 2400
phpro: posts big blind 4800
*** HOLE CARDS ***
Dealt to phpro [Qs 2h]
7SkYy: raises 4800 to 9600
bullen1414: folds
McLci: folds
oldyellowbricks: raises 19422 to 29022 and is all-in
dimasiktuta: raises 133271 to 162293 and is all-in
ValeraB96: folds
phpro: folds
7SkYy: folds
Uncalled bet (133271) returned to dimasiktuta
*** FLOP *** [8s 3h Qh]
*** TURN *** [8s 3h Qh] [8c]
*** RIVER *** [8s 3h Qh 8c] [4h]
*** SHOW DOWN ***
oldyellowbricks: shows [Kc Ad] (a pair of Eights)
dimasiktuta: shows [Ts Td] (two pair, Tens and Eights)
dimasiktuta collected 79044 from pot
oldyellowbricks finished the tournament in 7th place and received $9.64.
*** SUMMARY ***
Total pot 79044 | Rake 0
Board [8s 3h Qh 8c 4h]
Seat 1: oldyellowbricks showed [Kc Ad] and lost with a pair of Eights
Seat 2: dimasiktuta (button) showed [Ts Td] and won (79044) with two pair, Tens and Eights
Seat 5: ValeraB96 (small blind) folded before Flop
Seat 6: phpro (big blind) folded before Flop
Seat 7: 7SkYy folded before Flop
Seat 8: bullen1414 folded before Flop (didn't bet)
Seat 9: McLci folded before Flop (didn't bet)


*********** # 304 **************
PokerStars Hand #257048419516: Tournament #3910307458, $0.98+$0.12 USD Hold'em No Limit - Level XXVIII (2400/4800) - 2025/07/22 14:19:46 ET
Table '3910307458 12' 9-max Seat #5 is the button
Seat 2: dimasiktuta (212315 in chips)
Seat 5: ValeraB96 (70808 in chips)
Seat 6: phpro (124105 in chips)
Seat 7: 7SkYy (65517 in chips)
Seat 8: bullen1414 (206530 in chips)
Seat 9: McLci (184725 in chips)
dimasiktuta: posts the ante 600
ValeraB96: posts the ante 600
phpro: posts the ante 600
7SkYy: posts the ante 600
bullen1414: posts the ante 600
McLci: posts the ante 600
phpro: posts small blind 2400
7SkYy: posts big blind 4800
*** HOLE CARDS ***
Dealt to phpro [Kd Jh]
bullen1414: folds
McLci: folds
dimasiktuta: raises 4800 to 9600
ValeraB96: folds
phpro: folds
7SkYy: folds
Uncalled bet (4800) returned to dimasiktuta
dimasiktuta collected 15600 from pot
dimasiktuta: doesn't show hand
*** SUMMARY ***
Total pot 15600 | Rake 0
Seat 2: dimasiktuta collected (15600)
Seat 5: ValeraB96 (button) folded before Flop (didn't bet)
Seat 6: phpro (small blind) folded before Flop
Seat 7: 7SkYy (big blind) folded before Flop
Seat 8: bullen1414 folded before Flop (didn't bet)
Seat 9: McLci folded before Flop (didn't bet)


*********** # 305 **************
PokerStars Hand #257048424622: Tournament #3910307458, $0.98+$0.12 USD Hold'em No Limit - Level XXVIII (2400/4800) - 2025/07/22 14:20:10 ET
Table '3910307458 12' 9-max Seat #6 is the button
Seat 2: dimasiktuta (222515 in chips)
Seat 5: ValeraB96 (70208 in chips)
Seat 6: phpro (121105 in chips)
Seat 7: 7SkYy (60117 in chips)
Seat 8: bullen1414 (205930 in chips)
Seat 9: McLci (184125 in chips)
dimasiktuta: posts the ante 600
ValeraB96: posts the ante 600
phpro: posts the ante 600
7SkYy: posts the ante 600
bullen1414: posts the ante 600
McLci: posts the ante 600
7SkYy: posts small blind 2400
bullen1414: posts big blind 4800
*** HOLE CARDS ***
Dealt to phpro [4c 5h]
McLci: raises 4800 to 9600
dimasiktuta: folds
ValeraB96: folds
phpro: folds
7SkYy: folds
bullen1414: calls 4800
*** FLOP *** [8s 2c Th]
bullen1414: checks
McLci: bets 9600
bullen1414: calls 9600
*** TURN *** [8s 2c Th] [Kd]
bullen1414: checks
McLci: bets 22200
bullen1414: calls 22200
*** RIVER *** [8s 2c Th Kd] [9h]
bullen1414: checks
McLci: checks
*** SHOW DOWN ***
bullen1414: shows [2h 2s] (three of a kind, Deuces)
McLci: mucks hand
bullen1414 collected 88800 from pot
*** SUMMARY ***
Total pot 88800 | Rake 0
Board [8s 2c Th Kd 9h]
Seat 2: dimasiktuta folded before Flop (didn't bet)
Seat 5: ValeraB96 folded before Flop (didn't bet)
Seat 6: phpro (button) folded before Flop (didn't bet)
Seat 7: 7SkYy (small blind) folded before Flop
Seat 8: bullen1414 (big blind) showed [2h 2s] and won (88800) with three of a kind, Deuces
Seat 9: McLci mucked [Qc Ks]


*********** # 306 **************
PokerStars Hand #257048434516: Tournament #3910307458, $0.98+$0.12 USD Hold'em No Limit - Level XXVIII (2400/4800) - 2025/07/22 14:20:58 ET
Table '3910307458 12' 9-max Seat #7 is the button
Seat 2: dimasiktuta (221915 in chips)
Seat 5: ValeraB96 (69608 in chips)
Seat 6: phpro (120505 in chips)
Seat 7: 7SkYy (57117 in chips)
Seat 8: bullen1414 (252730 in chips)
Seat 9: McLci (142125 in chips)
dimasiktuta: posts the ante 600
ValeraB96: posts the ante 600
phpro: posts the ante 600
7SkYy: posts the ante 600
bullen1414: posts the ante 600
McLci: posts the ante 600
bullen1414: posts small blind 2400
McLci: posts big blind 4800
*** HOLE CARDS ***
Dealt to phpro [9s Kh]
dimasiktuta: folds
ValeraB96: raises 4800 to 9600
phpro: folds
7SkYy: folds
bullen1414: folds
McLci: folds
Uncalled bet (4800) returned to ValeraB96
ValeraB96 collected 15600 from pot
ValeraB96: doesn't show hand
*** SUMMARY ***
Total pot 15600 | Rake 0
Seat 2: dimasiktuta folded before Flop (didn't bet)
Seat 5: ValeraB96 collected (15600)
Seat 6: phpro folded before Flop (didn't bet)
Seat 7: 7SkYy (button) folded before Flop (didn't bet)
Seat 8: bullen1414 (small blind) folded before Flop
Seat 9: McLci (big blind) folded before Flop


*********** # 307 **************
PokerStars Hand #257048443212: Tournament #3910307458, $0.98+$0.12 USD Hold'em No Limit - Level XXVIII (2400/4800) - 2025/07/22 14:21:39 ET
Table '3910307458 12' 9-max Seat #8 is the button
Seat 2: dimasiktuta (221315 in chips)
Seat 5: ValeraB96 (79808 in chips)
Seat 6: phpro (119905 in chips)
Seat 7: 7SkYy (56517 in chips)
Seat 8: bullen1414 (249730 in chips)
Seat 9: McLci (136725 in chips)
dimasiktuta: posts the ante 600
ValeraB96: posts the ante 600
phpro: posts the ante 600
7SkYy: posts the ante 600
bullen1414: posts the ante 600
McLci: posts the ante 600
McLci: posts small blind 2400
dimasiktuta: posts big blind 4800
*** HOLE CARDS ***
Dealt to phpro [9h 6h]
ValeraB96: folds
phpro: folds
7SkYy: folds
bullen1414: folds
McLci: calls 2400
dimasiktuta: raises 9600 to 14400
McLci: calls 9600
*** FLOP *** [5d 6s Kh]
McLci: checks
dimasiktuta: checks
*** TURN *** [5d 6s Kh] [8s]
McLci: checks
dimasiktuta: checks
*** RIVER *** [5d 6s Kh 8s] [Ks]
McLci: checks
dimasiktuta: checks
*** SHOW DOWN ***
McLci: shows [9d Ad] (a pair of Kings)
dimasiktuta: mucks hand
McLci collected 32400 from pot
*** SUMMARY ***
Total pot 32400 | Rake 0
Board [5d 6s Kh 8s Ks]
Seat 2: dimasiktuta (big blind) mucked [9s Th]
Seat 5: ValeraB96 folded before Flop (didn't bet)
Seat 6: phpro folded before Flop (didn't bet)
Seat 7: 7SkYy folded before Flop (didn't bet)
Seat 8: bullen1414 (button) folded before Flop (didn't bet)
Seat 9: McLci (small blind) showed [9d Ad] and won (32400) with a pair of Kings


*********** # 308 **************
PokerStars Hand #257048459254: Tournament #3910307458, $0.98+$0.12 USD Hold'em No Limit - Level XXVIII (2400/4800) - 2025/07/22 14:22:56 ET
Table '3910307458 12' 9-max Seat #9 is the button
Seat 2: dimasiktuta (206315 in chips)
Seat 5: ValeraB96 (79208 in chips)
Seat 6: phpro (119305 in chips)
Seat 7: 7SkYy (55917 in chips)
Seat 8: bullen1414 (249130 in chips)
Seat 9: McLci (154125 in chips)
dimasiktuta: posts the ante 600
ValeraB96: posts the ante 600
phpro: posts the ante 600
7SkYy: posts the ante 600
bullen1414: posts the ante 600
McLci: posts the ante 600
dimasiktuta: posts small blind 2400
ValeraB96: posts big blind 4800
*** HOLE CARDS ***
Dealt to phpro [9s 7h]
phpro: folds
7SkYy: folds
bullen1414: folds
McLci: raises 4800 to 9600
dimasiktuta: folds
ValeraB96: raises 69008 to 78608 and is all-in
McLci: folds
Uncalled bet (69008) returned to ValeraB96
ValeraB96 collected 25200 from pot
ValeraB96: doesn't show hand
*** SUMMARY ***
Total pot 25200 | Rake 0
Seat 2: dimasiktuta (small blind) folded before Flop
Seat 5: ValeraB96 (big blind) collected (25200)
Seat 6: phpro folded before Flop (didn't bet)
Seat 7: 7SkYy folded before Flop (didn't bet)
Seat 8: bullen1414 folded before Flop (didn't bet)
Seat 9: McLci (button) folded before Flop


*********** # 309 **************
PokerStars Hand #257048468233: Tournament #3910307458, $0.98+$0.12 USD Hold'em No Limit - Level XXVIII (2400/4800) - 2025/07/22 14:23:39 ET
Table '3910307458 12' 9-max Seat #2 is the button
Seat 2: dimasiktuta (203315 in chips)
Seat 5: ValeraB96 (94208 in chips)
Seat 6: phpro (118705 in chips)
Seat 7: 7SkYy (55317 in chips)
Seat 8: bullen1414 (248530 in chips)
Seat 9: McLci (143925 in chips)
dimasiktuta: posts the ante 600
ValeraB96: posts the ante 600
phpro: posts the ante 600
7SkYy: posts the ante 600
bullen1414: posts the ante 600
McLci: posts the ante 600
ValeraB96: posts small blind 2400
phpro: posts big blind 4800
*** HOLE CARDS ***
Dealt to phpro [3c 2s]
7SkYy: folds
bullen1414: folds
McLci: folds
dimasiktuta: raises 4800 to 9600
ValeraB96: folds
phpro: calls 4800
*** FLOP *** [Jc 9d 3h]
phpro: checks
dimasiktuta: checks
*** TURN *** [Jc 9d 3h] [Ks]
phpro: checks
dimasiktuta: bets 9600
phpro: folds
Uncalled bet (9600) returned to dimasiktuta
dimasiktuta collected 25200 from pot
dimasiktuta: doesn't show hand
*** SUMMARY ***
Total pot 25200 | Rake 0
Board [Jc 9d 3h Ks]
Seat 2: dimasiktuta (button) collected (25200)
Seat 5: ValeraB96 (small blind) folded before Flop
Seat 6: phpro (big blind) folded on the Turn
Seat 7: 7SkYy folded before Flop (didn't bet)
Seat 8: bullen1414 folded before Flop (didn't bet)
Seat 9: McLci folded before Flop (didn't bet)


*********** # 310 **************
PokerStars Hand #257048476564: Tournament #3910307458, $0.98+$0.12 USD Hold'em No Limit - Level XXVIII (2400/4800) - 2025/07/22 14:24:19 ET
Table '3910307458 12' 9-max Seat #5 is the button
Seat 2: dimasiktuta (218315 in chips)
Seat 5: ValeraB96 (91208 in chips)
Seat 6: phpro (108505 in chips)
Seat 7: 7SkYy (54717 in chips)
Seat 8: bullen1414 (247930 in chips)
Seat 9: McLci (143325 in chips)
dimasiktuta: posts the ante 600
ValeraB96: posts the ante 600
phpro: posts the ante 600
7SkYy: posts the ante 600
bullen1414: posts the ante 600
McLci: posts the ante 600
phpro: posts small blind 2400
7SkYy: posts big blind 4800
*** HOLE CARDS ***
Dealt to phpro [5h Ac]
bullen1414: raises 5280 to 10080
McLci: calls 10080
dimasiktuta: folds
ValeraB96: folds
phpro: folds
7SkYy: folds
*** FLOP *** [7s 9c Qc]
bullen1414: checks
McLci: checks
*** TURN *** [7s 9c Qc] [Qd]
bullen1414: checks
McLci: bets 9600
bullen1414: folds
Uncalled bet (9600) returned to McLci
McLci collected 30960 from pot
McLci: doesn't show hand
*** SUMMARY ***
Total pot 30960 | Rake 0
Board [7s 9c Qc Qd]
Seat 2: dimasiktuta folded before Flop (didn't bet)
Seat 5: ValeraB96 (button) folded before Flop (didn't bet)
Seat 6: phpro (small blind) folded before Flop
Seat 7: 7SkYy (big blind) folded before Flop
Seat 8: bullen1414 folded on the Turn
Seat 9: McLci collected (30960)


*********** # 311 **************
PokerStars Hand #257048486055: Tournament #3910307458, $0.98+$0.12 USD Hold'em No Limit - Level XXIX (2800/5600) - 2025/07/22 14:25:04 ET
Table '3910307458 12' 9-max Seat #6 is the button
Seat 2: dimasiktuta (217715 in chips)
Seat 5: ValeraB96 (90608 in chips)
Seat 6: phpro (105505 in chips)
Seat 7: 7SkYy (49317 in chips)
Seat 8: bullen1414 (237250 in chips)
Seat 9: McLci (163605 in chips)
dimasiktuta: posts the ante 700
ValeraB96: posts the ante 700
phpro: posts the ante 700
7SkYy: posts the ante 700
bullen1414: posts the ante 700
McLci: posts the ante 700
7SkYy: posts small blind 2800
bullen1414: posts big blind 5600
*** HOLE CARDS ***
Dealt to phpro [Jd Th]
McLci: folds
dimasiktuta: folds
phpro is disconnected
ValeraB96: raises 84308 to 89908 and is all-in
phpro is connected
phpro: folds
7SkYy: folds
bullen1414: folds
Uncalled bet (84308) returned to ValeraB96
ValeraB96 collected 18200 from pot
ValeraB96: doesn't show hand
*** SUMMARY ***
Total pot 18200 | Rake 0
Seat 2: dimasiktuta folded before Flop (didn't bet)
Seat 5: ValeraB96 collected (18200)
Seat 6: phpro (button) folded before Flop (didn't bet)
Seat 7: 7SkYy (small blind) folded before Flop
Seat 8: bullen1414 (big blind) folded before Flop
Seat 9: McLci folded before Flop (didn't bet)


*********** # 312 **************
PokerStars Hand #257048493605: Tournament #3910307458, $0.98+$0.12 USD Hold'em No Limit - Level XXIX (2800/5600) - 2025/07/22 14:25:40 ET
Table '3910307458 12' 9-max Seat #7 is the button
Seat 2: dimasiktuta (217015 in chips)
Seat 5: ValeraB96 (102508 in chips)
Seat 6: phpro (104805 in chips)
Seat 7: 7SkYy (45817 in chips)
Seat 8: bullen1414 (230950 in chips)
Seat 9: McLci (162905 in chips)
dimasiktuta: posts the ante 700
ValeraB96: posts the ante 700
phpro: posts the ante 700
7SkYy: posts the ante 700
bullen1414: posts the ante 700
McLci: posts the ante 700
bullen1414: posts small blind 2800
McLci: posts big blind 5600
*** HOLE CARDS ***
Dealt to phpro [3c 4h]
dimasiktuta: folds
ValeraB96: folds
phpro: folds
7SkYy: raises 39517 to 45117 and is all-in
bullen1414: folds
McLci: folds
Uncalled bet (39517) returned to 7SkYy
7SkYy collected 18200 from pot
7SkYy: doesn't show hand
*** SUMMARY ***
Total pot 18200 | Rake 0
Seat 2: dimasiktuta folded before Flop (didn't bet)
Seat 5: ValeraB96 folded before Flop (didn't bet)
Seat 6: phpro folded before Flop (didn't bet)
Seat 7: 7SkYy (button) collected (18200)
Seat 8: bullen1414 (small blind) folded before Flop
Seat 9: McLci (big blind) folded before Flop


*********** # 313 **************
PokerStars Hand #257048499463: Tournament #3910307458, $0.98+$0.12 USD Hold'em No Limit - Level XXIX (2800/5600) - 2025/07/22 14:26:08 ET
Table '3910307458 12' 9-max Seat #8 is the button
Seat 2: dimasiktuta (216315 in chips)
Seat 5: ValeraB96 (101808 in chips)
Seat 6: phpro (104105 in chips)
Seat 7: 7SkYy (57717 in chips)
Seat 8: bullen1414 (227450 in chips)
Seat 9: McLci (156605 in chips)
dimasiktuta: posts the ante 700
ValeraB96: posts the ante 700
phpro: posts the ante 700
7SkYy: posts the ante 700
bullen1414: posts the ante 700
McLci: posts the ante 700
McLci: posts small blind 2800
dimasiktuta: posts big blind 5600
*** HOLE CARDS ***
Dealt to phpro [6c 8c]
ValeraB96: folds
phpro: folds
7SkYy: raises 51417 to 57017 and is all-in
bullen1414: folds
McLci: folds
dimasiktuta: calls 51417
*** FLOP *** [Kd 7s 4h]
*** TURN *** [Kd 7s 4h] [4s]
*** RIVER *** [Kd 7s 4h 4s] [As]
*** SHOW DOWN ***
dimasiktuta: shows [Kc Qs] (two pair, Kings and Fours)
7SkYy: shows [8d Ah] (two pair, Aces and Fours)
7SkYy collected 121034 from pot
*** SUMMARY ***
Total pot 121034 | Rake 0
Board [Kd 7s 4h 4s As]
Seat 2: dimasiktuta (big blind) showed [Kc Qs] and lost with two pair, Kings and Fours
Seat 5: ValeraB96 folded before Flop (didn't bet)
Seat 6: phpro folded before Flop (didn't bet)
Seat 7: 7SkYy showed [8d Ah] and won (121034) with two pair, Aces and Fours
Seat 8: bullen1414 (button) folded before Flop (didn't bet)
Seat 9: McLci (small blind) folded before Flop


*********** # 314 **************
PokerStars Hand #257048505574: Tournament #3910307458, $0.98+$0.12 USD Hold'em No Limit - Level XXIX (2800/5600) - 2025/07/22 14:26:37 ET
Table '3910307458 12' 9-max Seat #9 is the button
Seat 2: dimasiktuta (158598 in chips)
Seat 5: ValeraB96 (101108 in chips)
Seat 6: phpro (103405 in chips)
Seat 7: 7SkYy (121034 in chips)
Seat 8: bullen1414 (226750 in chips)
Seat 9: McLci (153105 in chips)
dimasiktuta: posts the ante 700
ValeraB96: posts the ante 700
phpro: posts the ante 700
7SkYy: posts the ante 700
bullen1414: posts the ante 700
McLci: posts the ante 700
dimasiktuta: posts small blind 2800
ValeraB96: posts big blind 5600
*** HOLE CARDS ***
Dealt to phpro [Ah 8h]
phpro: raises 5600 to 11200
7SkYy: folds
bullen1414: folds
McLci: folds
dimasiktuta: folds
ValeraB96: folds
Uncalled bet (5600) returned to phpro
phpro collected 18200 from pot
*** SUMMARY ***
Total pot 18200 | Rake 0
Seat 2: dimasiktuta (small blind) folded before Flop
Seat 5: ValeraB96 (big blind) folded before Flop
Seat 6: phpro collected (18200)
Seat 7: 7SkYy folded before Flop (didn't bet)
Seat 8: bullen1414 folded before Flop (didn't bet)
Seat 9: McLci (button) folded before Flop (didn't bet)


*********** # 315 **************
PokerStars Hand #257048510154: Tournament #3910307458, $0.98+$0.12 USD Hold'em No Limit - Level XXIX (2800/5600) - 2025/07/22 14:26:59 ET
Table '3910307458 12' 9-max Seat #2 is the button
Seat 2: dimasiktuta (155098 in chips)
Seat 5: ValeraB96 (94808 in chips)
Seat 6: phpro (115305 in chips)
Seat 7: 7SkYy (120334 in chips)
Seat 8: bullen1414 (226050 in chips)
Seat 9: McLci (152405 in chips)
dimasiktuta: posts the ante 700
ValeraB96: posts the ante 700
phpro: posts the ante 700
7SkYy: posts the ante 700
bullen1414: posts the ante 700
McLci: posts the ante 700
ValeraB96: posts small blind 2800
phpro: posts big blind 5600
*** HOLE CARDS ***
Dealt to phpro [Th 6s]
7SkYy: folds
bullen1414: folds
McLci: folds
dimasiktuta: raises 5600 to 11200
ValeraB96: folds
phpro: folds
Uncalled bet (5600) returned to dimasiktuta
dimasiktuta collected 18200 from pot
dimasiktuta: doesn't show hand
*** SUMMARY ***
Total pot 18200 | Rake 0
Seat 2: dimasiktuta (button) collected (18200)
Seat 5: ValeraB96 (small blind) folded before Flop
Seat 6: phpro (big blind) folded before Flop
Seat 7: 7SkYy folded before Flop (didn't bet)
Seat 8: bullen1414 folded before Flop (didn't bet)
Seat 9: McLci folded before Flop (didn't bet)


*********** # 316 **************
PokerStars Hand #257048513150: Tournament #3910307458, $0.98+$0.12 USD Hold'em No Limit - Level XXIX (2800/5600) - 2025/07/22 14:27:14 ET
Table '3910307458 12' 9-max Seat #5 is the button
Seat 2: dimasiktuta (166998 in chips)
Seat 5: ValeraB96 (91308 in chips)
Seat 6: phpro (109005 in chips)
Seat 7: 7SkYy (119634 in chips)
Seat 8: bullen1414 (225350 in chips)
Seat 9: McLci (151705 in chips)
dimasiktuta: posts the ante 700
ValeraB96: posts the ante 700
phpro: posts the ante 700
7SkYy: posts the ante 700
bullen1414: posts the ante 700
McLci: posts the ante 700
phpro: posts small blind 2800
7SkYy: posts big blind 5600
*** HOLE CARDS ***
Dealt to phpro [7s 8h]
bullen1414: folds
McLci: folds
dimasiktuta: folds
ValeraB96: folds
phpro: raises 5600 to 11200
7SkYy: folds
Uncalled bet (5600) returned to phpro
phpro collected 15400 from pot
*** SUMMARY ***
Total pot 15400 | Rake 0
Seat 2: dimasiktuta folded before Flop (didn't bet)
Seat 5: ValeraB96 (button) folded before Flop (didn't bet)
Seat 6: phpro (small blind) collected (15400)
Seat 7: 7SkYy (big blind) folded before Flop
Seat 8: bullen1414 folded before Flop (didn't bet)
Seat 9: McLci folded before Flop (didn't bet)


*********** # 317 **************
PokerStars Hand #257048517776: Tournament #3910307458, $0.98+$0.12 USD Hold'em No Limit - Level XXIX (2800/5600) - 2025/07/22 14:27:36 ET
Table '3910307458 12' 9-max Seat #6 is the button
Seat 2: dimasiktuta (166298 in chips)
Seat 5: ValeraB96 (90608 in chips)
Seat 6: phpro (118105 in chips)
Seat 7: 7SkYy (113334 in chips)
Seat 8: bullen1414 (224650 in chips)
Seat 9: McLci (151005 in chips)
dimasiktuta: posts the ante 700
ValeraB96: posts the ante 700
phpro: posts the ante 700
7SkYy: posts the ante 700
bullen1414: posts the ante 700
McLci: posts the ante 700
7SkYy: posts small blind 2800
bullen1414: posts big blind 5600
*** HOLE CARDS ***
Dealt to phpro [3d Qc]
McLci: folds
dimasiktuta: raises 5600 to 11200
ValeraB96: folds
phpro: folds
7SkYy: folds
bullen1414: calls 5600
*** FLOP *** [7h 5c Qh]
bullen1414: checks
dimasiktuta: bets 11200
bullen1414: folds
Uncalled bet (11200) returned to dimasiktuta
dimasiktuta collected 29400 from pot
dimasiktuta: doesn't show hand
*** SUMMARY ***
Total pot 29400 | Rake 0
Board [7h 5c Qh]
Seat 2: dimasiktuta collected (29400)
Seat 5: ValeraB96 folded before Flop (didn't bet)
Seat 6: phpro (button) folded before Flop (didn't bet)
Seat 7: 7SkYy (small blind) folded before Flop
Seat 8: bullen1414 (big blind) folded on the Flop
Seat 9: McLci folded before Flop (didn't bet)


*********** # 318 **************
PokerStars Hand #257048522369: Tournament #3910307458, $0.98+$0.12 USD Hold'em No Limit - Level XXIX (2800/5600) - 2025/07/22 14:27:58 ET
Table '3910307458 12' 9-max Seat #7 is the button
Seat 2: dimasiktuta (183798 in chips)
Seat 5: ValeraB96 (89908 in chips)
Seat 6: phpro (117405 in chips)
Seat 7: 7SkYy (109834 in chips)
Seat 8: bullen1414 (212750 in chips)
Seat 9: McLci (150305 in chips)
dimasiktuta: posts the ante 700
ValeraB96: posts the ante 700
phpro: posts the ante 700
7SkYy: posts the ante 700
bullen1414: posts the ante 700
McLci: posts the ante 700
bullen1414: posts small blind 2800
McLci: posts big blind 5600
*** HOLE CARDS ***
Dealt to phpro [Ac 3s]
dimasiktuta: raises 5600 to 11200
ValeraB96: folds
phpro: folds
7SkYy: folds
bullen1414: calls 8400
McLci: folds
*** FLOP *** [5s 7h Jh]
bullen1414: checks
dimasiktuta: bets 11200
bullen1414: folds
Uncalled bet (11200) returned to dimasiktuta
dimasiktuta collected 32200 from pot
dimasiktuta: doesn't show hand
*** SUMMARY ***
Total pot 32200 | Rake 0
Board [5s 7h Jh]
Seat 2: dimasiktuta collected (32200)
Seat 5: ValeraB96 folded before Flop (didn't bet)
Seat 6: phpro folded before Flop (didn't bet)
Seat 7: 7SkYy (button) folded before Flop (didn't bet)
Seat 8: bullen1414 (small blind) folded on the Flop
Seat 9: McLci (big blind) folded before Flop


*********** # 319 **************
PokerStars Hand #257048529622: Tournament #3910307458, $0.98+$0.12 USD Hold'em No Limit - Level XXIX (2800/5600) - 2025/07/22 14:28:32 ET
Table '3910307458 12' 9-max Seat #8 is the button
Seat 2: dimasiktuta (204098 in chips)
Seat 5: ValeraB96 (89208 in chips)
Seat 6: phpro (116705 in chips)
Seat 7: 7SkYy (109134 in chips)
Seat 8: bullen1414 (200850 in chips)
Seat 9: McLci (144005 in chips)
dimasiktuta: posts the ante 700
ValeraB96: posts the ante 700
phpro: posts the ante 700
7SkYy: posts the ante 700
bullen1414: posts the ante 700
McLci: posts the ante 700
McLci: posts small blind 2800
dimasiktuta: posts big blind 5600
*** HOLE CARDS ***
Dealt to phpro [7d 4h]
ValeraB96: folds
phpro: folds
7SkYy: folds
bullen1414: folds
McLci: folds
Uncalled bet (2800) returned to dimasiktuta
dimasiktuta collected 9800 from pot
dimasiktuta: doesn't show hand
*** SUMMARY ***
Total pot 9800 | Rake 0
Seat 2: dimasiktuta (big blind) collected (9800)
Seat 5: ValeraB96 folded before Flop (didn't bet)
Seat 6: phpro folded before Flop (didn't bet)
Seat 7: 7SkYy folded before Flop (didn't bet)
Seat 8: bullen1414 (button) folded before Flop (didn't bet)
Seat 9: McLci (small blind) folded before Flop


*********** # 320 **************
PokerStars Hand #257048532619: Tournament #3910307458, $0.98+$0.12 USD Hold'em No Limit - Level XXIX (2800/5600) - 2025/07/22 14:28:46 ET
Table '3910307458 12' 9-max Seat #9 is the button
Seat 2: dimasiktuta (210398 in chips)
Seat 5: ValeraB96 (88508 in chips)
Seat 6: phpro (116005 in chips)
Seat 7: 7SkYy (108434 in chips)
Seat 8: bullen1414 (200150 in chips)
Seat 9: McLci (140505 in chips)
dimasiktuta: posts the ante 700
ValeraB96: posts the ante 700
phpro: posts the ante 700
7SkYy: posts the ante 700
bullen1414: posts the ante 700
McLci: posts the ante 700
dimasiktuta: posts small blind 2800
ValeraB96: posts big blind 5600
*** HOLE CARDS ***
Dealt to phpro [8h 6c]
phpro: folds
7SkYy: raises 5600 to 11200
bullen1414: folds
McLci: folds
dimasiktuta: folds
ValeraB96: folds
Uncalled bet (5600) returned to 7SkYy
7SkYy collected 18200 from pot
7SkYy: doesn't show hand
*** SUMMARY ***
Total pot 18200 | Rake 0
Seat 2: dimasiktuta (small blind) folded before Flop
Seat 5: ValeraB96 (big blind) folded before Flop
Seat 6: phpro folded before Flop (didn't bet)
Seat 7: 7SkYy collected (18200)
Seat 8: bullen1414 folded before Flop (didn't bet)
Seat 9: McLci (button) folded before Flop (didn't bet)


*********** # 321 **************
PokerStars Hand #257048535998: Tournament #3910307458, $0.98+$0.12 USD Hold'em No Limit - Level XXIX (2800/5600) - 2025/07/22 14:29:03 ET
Table '3910307458 12' 9-max Seat #2 is the button
Seat 2: dimasiktuta (206898 in chips)
Seat 5: ValeraB96 (82208 in chips)
Seat 6: phpro (115305 in chips)
Seat 7: 7SkYy (120334 in chips)
Seat 8: bullen1414 (199450 in chips)
Seat 9: McLci (139805 in chips)
dimasiktuta: posts the ante 700
ValeraB96: posts the ante 700
phpro: posts the ante 700
7SkYy: posts the ante 700
bullen1414: posts the ante 700
McLci: posts the ante 700
ValeraB96: posts small blind 2800
phpro: posts big blind 5600
*** HOLE CARDS ***
Dealt to phpro [Kh Ah]
7SkYy: folds
bullen1414: folds
McLci: folds
dimasiktuta: folds
ValeraB96: calls 2800
phpro: raises 11200 to 16800
ValeraB96: calls 11200
*** FLOP *** [Kd 5c Qc]
ValeraB96: checks
phpro: bets 18900
ValeraB96: raises 45808 to 64708 and is all-in
phpro: calls 45808
*** TURN *** [Kd 5c Qc] [Kc]
*** RIVER *** [Kd 5c Qc Kc] [6d]
*** SHOW DOWN ***
ValeraB96: shows [Tc Jc] (a flush, King high)
phpro: shows [Kh Ah] (three of a kind, Kings)
ValeraB96 collected 167216 from pot
*** SUMMARY ***
Total pot 167216 | Rake 0
Board [Kd 5c Qc Kc 6d]
Seat 2: dimasiktuta (button) folded before Flop (didn't bet)
Seat 5: ValeraB96 (small blind) showed [Tc Jc] and won (167216) with a flush, King high
Seat 6: phpro (big blind) showed [Kh Ah] and lost with three of a kind, Kings
Seat 7: 7SkYy folded before Flop (didn't bet)
Seat 8: bullen1414 folded before Flop (didn't bet)
Seat 9: McLci folded before Flop (didn't bet)


*********** # 322 **************
PokerStars Hand #257048542035: Tournament #3910307458, $0.98+$0.12 USD Hold'em No Limit - Level XXIX (2800/5600) - 2025/07/22 14:29:31 ET
Table '3910307458 12' 9-max Seat #5 is the button
Seat 2: dimasiktuta (206198 in chips)
Seat 5: ValeraB96 (167216 in chips)
Seat 6: phpro (33097 in chips)
Seat 7: 7SkYy (119634 in chips)
Seat 8: bullen1414 (198750 in chips)
Seat 9: McLci (139105 in chips)
dimasiktuta: posts the ante 700
ValeraB96: posts the ante 700
phpro: posts the ante 700
7SkYy: posts the ante 700
bullen1414: posts the ante 700
McLci: posts the ante 700
phpro: posts small blind 2800
7SkYy: posts big blind 5600
*** HOLE CARDS ***
Dealt to phpro [6s 7d]
bullen1414: folds
McLci: folds
dimasiktuta: folds
ValeraB96: raises 5600 to 11200
phpro: folds
7SkYy: folds
Uncalled bet (5600) returned to ValeraB96
ValeraB96 collected 18200 from pot
ValeraB96: doesn't show hand
*** SUMMARY ***
Total pot 18200 | Rake 0
Seat 2: dimasiktuta folded before Flop (didn't bet)
Seat 5: ValeraB96 (button) collected (18200)
Seat 6: phpro (small blind) folded before Flop
Seat 7: 7SkYy (big blind) folded before Flop
Seat 8: bullen1414 folded before Flop (didn't bet)
Seat 9: McLci folded before Flop (didn't bet)


*********** # 323 **************
PokerStars Hand #257048546904: Tournament #3910307458, $0.98+$0.12 USD Hold'em No Limit - Level XXIX (2800/5600) - 2025/07/22 14:29:55 ET
Table '3910307458 12' 9-max Seat #6 is the button
Seat 2: dimasiktuta (205498 in chips)
Seat 5: ValeraB96 (179116 in chips)
Seat 6: phpro (29597 in chips)
Seat 7: 7SkYy (113334 in chips)
Seat 8: bullen1414 (198050 in chips)
Seat 9: McLci (138405 in chips)
dimasiktuta: posts the ante 700
ValeraB96: posts the ante 700
phpro: posts the ante 700
7SkYy: posts the ante 700
bullen1414: posts the ante 700
McLci: posts the ante 700
7SkYy: posts small blind 2800
bullen1414: posts big blind 5600
*** HOLE CARDS ***
Dealt to phpro [5d 8s]
McLci: folds
dimasiktuta: raises 5600 to 11200
ValeraB96: folds
phpro: folds
7SkYy: folds
bullen1414: folds
Uncalled bet (5600) returned to dimasiktuta
dimasiktuta collected 18200 from pot
dimasiktuta: doesn't show hand
*** SUMMARY ***
Total pot 18200 | Rake 0
Seat 2: dimasiktuta collected (18200)
Seat 5: ValeraB96 folded before Flop (didn't bet)
Seat 6: phpro (button) folded before Flop (didn't bet)
Seat 7: 7SkYy (small blind) folded before Flop
Seat 8: bullen1414 (big blind) folded before Flop
Seat 9: McLci folded before Flop (didn't bet)


*********** # 324 **************
PokerStars Hand #257048552358: Tournament #3910307458, $0.98+$0.12 USD Hold'em No Limit - Level XXIX (2800/5600) - 2025/07/22 14:30:19 ET
Table '3910307458 12' 9-max Seat #7 is the button
Seat 2: dimasiktuta (217398 in chips)
Seat 5: ValeraB96 (178416 in chips)
Seat 6: phpro (28897 in chips)
Seat 7: 7SkYy (109834 in chips)
Seat 8: bullen1414 (191750 in chips)
Seat 9: McLci (137705 in chips)
dimasiktuta: posts the ante 700
ValeraB96: posts the ante 700
phpro: posts the ante 700
7SkYy: posts the ante 700
bullen1414: posts the ante 700
McLci: posts the ante 700
bullen1414: posts small blind 2800
McLci: posts big blind 5600
*** HOLE CARDS ***
Dealt to phpro [As 8c]
dimasiktuta: folds
ValeraB96: folds
phpro: raises 22597 to 28197 and is all-in
7SkYy: folds
bullen1414: calls 25397
McLci: folds
*** FLOP *** [Qs Js Ks]
*** TURN *** [Qs Js Ks] [Th]
*** RIVER *** [Qs Js Ks Th] [9s]
*** SHOW DOWN ***
bullen1414: shows [Kc Jd] (a straight, Nine to King)
phpro: shows [As 8c] (a flush, Ace high)
phpro collected 66194 from pot
*** SUMMARY ***
Total pot 66194 | Rake 0
Board [Qs Js Ks Th 9s]
Seat 2: dimasiktuta folded before Flop (didn't bet)
Seat 5: ValeraB96 folded before Flop (didn't bet)
Seat 6: phpro showed [As 8c] and won (66194) with a flush, Ace high
Seat 7: 7SkYy (button) folded before Flop (didn't bet)
Seat 8: bullen1414 (small blind) showed [Kc Jd] and lost with a straight, Nine to King
Seat 9: McLci (big blind) folded before Flop


*********** # 325 **************
PokerStars Hand #257048557920: Tournament #3910307458, $0.98+$0.12 USD Hold'em No Limit - Level XXIX (2800/5600) - 2025/07/22 14:30:46 ET
Table '3910307458 12' 9-max Seat #8 is the button
Seat 2: dimasiktuta (216698 in chips)
Seat 5: ValeraB96 (177716 in chips)
Seat 6: phpro (66194 in chips)
Seat 7: 7SkYy (109134 in chips)
Seat 8: bullen1414 (162853 in chips)
Seat 9: McLci (131405 in chips)
dimasiktuta: posts the ante 700
ValeraB96: posts the ante 700
phpro: posts the ante 700
7SkYy: posts the ante 700
bullen1414: posts the ante 700
McLci: posts the ante 700
McLci: posts small blind 2800
dimasiktuta: posts big blind 5600
*** HOLE CARDS ***
Dealt to phpro [Ts 6c]
ValeraB96: folds
phpro: folds
7SkYy: raises 5600 to 11200
bullen1414: folds
McLci: folds
dimasiktuta: calls 5600
*** FLOP *** [3d 3c 9c]
dimasiktuta: checks
7SkYy: checks
*** TURN *** [3d 3c 9c] [2h]
dimasiktuta: bets 10290
7SkYy: folds
Uncalled bet (10290) returned to dimasiktuta
dimasiktuta collected 29400 from pot
dimasiktuta: doesn't show hand
*** SUMMARY ***
Total pot 29400 | Rake 0
Board [3d 3c 9c 2h]
Seat 2: dimasiktuta (big blind) collected (29400)
Seat 5: ValeraB96 folded before Flop (didn't bet)
Seat 6: phpro folded before Flop (didn't bet)
Seat 7: 7SkYy folded on the Turn
Seat 8: bullen1414 (button) folded before Flop (didn't bet)
Seat 9: McLci (small blind) folded before Flop


*********** # 326 **************
PokerStars Hand #257048565062: Tournament #3910307458, $0.98+$0.12 USD Hold'em No Limit - Level XXIX (2800/5600) - 2025/07/22 14:31:20 ET
Table '3910307458 12' 9-max Seat #9 is the button
Seat 2: dimasiktuta (234198 in chips)
Seat 5: ValeraB96 (177016 in chips)
Seat 6: phpro (65494 in chips)
Seat 7: 7SkYy (97234 in chips)
Seat 8: bullen1414 (162153 in chips)
Seat 9: McLci (127905 in chips)
dimasiktuta: posts the ante 700
ValeraB96: posts the ante 700
phpro: posts the ante 700
7SkYy: posts the ante 700
bullen1414: posts the ante 700
McLci: posts the ante 700
dimasiktuta: posts small blind 2800
ValeraB96: posts big blind 5600
*** HOLE CARDS ***
Dealt to phpro [7c Kh]
phpro: folds
7SkYy: folds
bullen1414: raises 6160 to 11760
McLci: folds
dimasiktuta: folds
ValeraB96: calls 6160
*** FLOP *** [Jh Qs 7h]
ValeraB96: checks
bullen1414: bets 12208
ValeraB96: raises 28780 to 40988
bullen1414: folds
Uncalled bet (28780) returned to ValeraB96
ValeraB96 collected 54936 from pot
ValeraB96: doesn't show hand
*** SUMMARY ***
Total pot 54936 | Rake 0
Board [Jh Qs 7h]
Seat 2: dimasiktuta (small blind) folded before Flop
Seat 5: ValeraB96 (big blind) collected (54936)
Seat 6: phpro folded before Flop (didn't bet)
Seat 7: 7SkYy folded before Flop (didn't bet)
Seat 8: bullen1414 folded on the Flop
Seat 9: McLci (button) folded before Flop (didn't bet)


*********** # 327 **************
PokerStars Hand #257048581452: Tournament #3910307458, $0.98+$0.12 USD Hold'em No Limit - Level XXIX (2800/5600) - 2025/07/22 14:32:39 ET
Table '3910307458 12' 9-max Seat #2 is the button
Seat 2: dimasiktuta (230698 in chips)
Seat 5: ValeraB96 (207284 in chips)
Seat 6: phpro (64794 in chips)
Seat 7: 7SkYy (96534 in chips)
Seat 8: bullen1414 (137485 in chips)
Seat 9: McLci (127205 in chips)
dimasiktuta: posts the ante 700
ValeraB96: posts the ante 700
phpro: posts the ante 700
7SkYy: posts the ante 700
bullen1414: posts the ante 700
McLci: posts the ante 700
ValeraB96: posts small blind 2800
phpro: posts big blind 5600
*** HOLE CARDS ***
Dealt to phpro [6h 4s]
7SkYy: folds
bullen1414: folds
McLci: folds
dimasiktuta: raises 5600 to 11200
ValeraB96: calls 8400
phpro: folds
*** FLOP *** [2d As 9c]
ValeraB96: checks
dimasiktuta: bets 11200
ValeraB96: folds
Uncalled bet (11200) returned to dimasiktuta
dimasiktuta collected 32200 from pot
dimasiktuta: doesn't show hand
*** SUMMARY ***
Total pot 32200 | Rake 0
Board [2d As 9c]
Seat 2: dimasiktuta (button) collected (32200)
Seat 5: ValeraB96 (small blind) folded on the Flop
Seat 6: phpro (big blind) folded before Flop
Seat 7: 7SkYy folded before Flop (didn't bet)
Seat 8: bullen1414 folded before Flop (didn't bet)
Seat 9: McLci folded before Flop (didn't bet)


*********** # 328 **************
PokerStars Hand #257048590818: Tournament #3910307458, $0.98+$0.12 USD Hold'em No Limit - Level XXIX (2800/5600) - 2025/07/22 14:33:23 ET
Table '3910307458 12' 9-max Seat #5 is the button
Seat 2: dimasiktuta (250998 in chips)
Seat 5: ValeraB96 (195384 in chips)
Seat 6: phpro (58494 in chips)
Seat 7: 7SkYy (95834 in chips)
Seat 8: bullen1414 (136785 in chips)
Seat 9: McLci (126505 in chips)
dimasiktuta: posts the ante 700
ValeraB96: posts the ante 700
phpro: posts the ante 700
7SkYy: posts the ante 700
bullen1414: posts the ante 700
McLci: posts the ante 700
phpro: posts small blind 2800
7SkYy: posts big blind 5600
*** HOLE CARDS ***
Dealt to phpro [7c 6c]
bullen1414: raises 6160 to 11760
McLci: calls 11760
dimasiktuta: calls 11760
ValeraB96: folds
phpro: folds
7SkYy: folds
*** FLOP *** [9s Kh 3s]
bullen1414: checks
McLci: bets 11200
dimasiktuta: folds
bullen1414: calls 11200
*** TURN *** [9s Kh 3s] [6h]
bullen1414: checks
McLci: bets 33600
bullen1414: folds
Uncalled bet (33600) returned to McLci
McLci collected 70280 from pot
McLci: doesn't show hand
*** SUMMARY ***
Total pot 70280 | Rake 0
Board [9s Kh 3s 6h]
Seat 2: dimasiktuta folded on the Flop
Seat 5: ValeraB96 (button) folded before Flop (didn't bet)
Seat 6: phpro (small blind) folded before Flop
Seat 7: 7SkYy (big blind) folded before Flop
Seat 8: bullen1414 folded on the Turn
Seat 9: McLci collected (70280)


*********** # 329 **************
PokerStars Hand #257048601833: Tournament #3910307458, $0.98+$0.12 USD Hold'em No Limit - Level XXIX (2800/5600) - 2025/07/22 14:34:16 ET
Table '3910307458 12' 9-max Seat #6 is the button
Seat 2: dimasiktuta (238538 in chips)
Seat 5: ValeraB96 (194684 in chips)
Seat 6: phpro (54994 in chips)
Seat 7: 7SkYy (89534 in chips)
Seat 8: bullen1414 (113125 in chips)
Seat 9: McLci (173125 in chips)
dimasiktuta: posts the ante 700
ValeraB96: posts the ante 700
phpro: posts the ante 700
7SkYy: posts the ante 700
bullen1414: posts the ante 700
McLci: posts the ante 700
7SkYy: posts small blind 2800
bullen1414: posts big blind 5600
*** HOLE CARDS ***
Dealt to phpro [Kd Kh]
McLci: folds
dimasiktuta: folds
ValeraB96: raises 5600 to 11200
phpro: raises 5600 to 16800
7SkYy: folds
bullen1414: folds
ValeraB96: calls 5600
*** FLOP *** [8c 3s Jd]
ValeraB96: checks
phpro: bets 37494 and is all-in
ValeraB96: calls 37494
*** TURN *** [8c 3s Jd] [2d]
*** RIVER *** [8c 3s Jd 2d] [9h]
*** SHOW DOWN ***
ValeraB96: shows [3c Ah] (a pair of Threes)
phpro: shows [Kd Kh] (a pair of Kings)
phpro collected 121188 from pot
*** SUMMARY ***
Total pot 121188 | Rake 0
Board [8c 3s Jd 2d 9h]
Seat 2: dimasiktuta folded before Flop (didn't bet)
Seat 5: ValeraB96 showed [3c Ah] and lost with a pair of Threes
Seat 6: phpro (button) showed [Kd Kh] and won (121188) with a pair of Kings
Seat 7: 7SkYy (small blind) folded before Flop
Seat 8: bullen1414 (big blind) folded before Flop
Seat 9: McLci folded before Flop (didn't bet)


*********** # 330 **************
PokerStars Hand #257048609334: Tournament #3910307458, $0.98+$0.12 USD Hold'em No Limit - Level XXIX (2800/5600) - 2025/07/22 14:34:52 ET
Table '3910307458 12' 9-max Seat #7 is the button
Seat 2: dimasiktuta (237838 in chips)
Seat 5: ValeraB96 (139690 in chips)
Seat 6: phpro (121188 in chips)
Seat 7: 7SkYy (86034 in chips)
Seat 8: bullen1414 (106825 in chips)
Seat 9: McLci (172425 in chips)
dimasiktuta: posts the ante 700
ValeraB96: posts the ante 700
phpro: posts the ante 700
7SkYy: posts the ante 700
bullen1414: posts the ante 700
McLci: posts the ante 700
bullen1414: posts small blind 2800
McLci: posts big blind 5600
*** HOLE CARDS ***
Dealt to phpro [Th 9d]
dimasiktuta: raises 5600 to 11200
ValeraB96: folds
phpro: folds
7SkYy: folds
bullen1414: raises 94925 to 106125 and is all-in
McLci: folds
dimasiktuta: calls 94925
*** FLOP *** [4d 5d 9h]
*** TURN *** [4d 5d 9h] [5c]
*** RIVER *** [4d 5d 9h 5c] [7c]
*** SHOW DOWN ***
bullen1414: shows [Ah Ts] (a pair of Fives)
dimasiktuta: shows [Js Jc] (two pair, Jacks and Fives)
dimasiktuta collected 222050 from pot
bullen1414 finished the tournament in 6th place and received $11.82.
*** SUMMARY ***
Total pot 222050 | Rake 0
Board [4d 5d 9h 5c 7c]
Seat 2: dimasiktuta showed [Js Jc] and won (222050) with two pair, Jacks and Fives
Seat 5: ValeraB96 folded before Flop (didn't bet)
Seat 6: phpro folded before Flop (didn't bet)
Seat 7: 7SkYy (button) folded before Flop (didn't bet)
Seat 8: bullen1414 (small blind) showed [Ah Ts] and lost with a pair of Fives
Seat 9: McLci (big blind) folded before Flop


*********** # 331 **************
PokerStars Hand #257048618044: Tournament #3910307458, $0.98+$0.12 USD Hold'em No Limit - Level XXX (3200/6400) - 2025/07/22 14:35:33 ET
Table '3910307458 12' 9-max Seat #9 is the button
Seat 2: dimasiktuta (353063 in chips)
Seat 5: ValeraB96 (138990 in chips)
Seat 6: phpro (120488 in chips)
Seat 7: 7SkYy (85334 in chips)
Seat 9: McLci (166125 in chips)
dimasiktuta: posts the ante 800
ValeraB96: posts the ante 800
phpro: posts the ante 800
7SkYy: posts the ante 800
McLci: posts the ante 800
dimasiktuta: posts small blind 3200
ValeraB96: posts big blind 6400
*** HOLE CARDS ***
Dealt to phpro [2d 4d]
phpro: folds
7SkYy: folds
McLci: raises 6400 to 12800
dimasiktuta: folds
ValeraB96: calls 6400
*** FLOP *** [Tc Ad Jd]
ValeraB96: checks
McLci: checks
*** TURN *** [Tc Ad Jd] [5h]
ValeraB96: bets 16896
McLci: folds
Uncalled bet (16896) returned to ValeraB96
ValeraB96 collected 32800 from pot
ValeraB96: doesn't show hand
*** SUMMARY ***
Total pot 32800 | Rake 0
Board [Tc Ad Jd 5h]
Seat 2: dimasiktuta (small blind) folded before Flop
Seat 5: ValeraB96 (big blind) collected (32800)
Seat 6: phpro folded before Flop (didn't bet)
Seat 7: 7SkYy folded before Flop (didn't bet)
Seat 9: McLci (button) folded on the Turn


*********** # 332 **************
PokerStars Hand #257048625735: Tournament #3910307458, $0.98+$0.12 USD Hold'em No Limit - Level XXX (3200/6400) - 2025/07/22 14:36:10 ET
Table '3910307458 12' 9-max Seat #2 is the button
Seat 2: dimasiktuta (349063 in chips)
Seat 5: ValeraB96 (158190 in chips)
Seat 6: phpro (119688 in chips)
Seat 7: 7SkYy (84534 in chips)
Seat 9: McLci (152525 in chips)
dimasiktuta: posts the ante 800
ValeraB96: posts the ante 800
phpro: posts the ante 800
7SkYy: posts the ante 800
McLci: posts the ante 800
ValeraB96: posts small blind 3200
phpro: posts big blind 6400
*** HOLE CARDS ***
Dealt to phpro [7d 5c]
7SkYy: folds
McLci: folds
dimasiktuta: raises 6400 to 12800
ValeraB96: folds
phpro: folds
Uncalled bet (6400) returned to dimasiktuta
dimasiktuta collected 20000 from pot
dimasiktuta: doesn't show hand
*** SUMMARY ***
Total pot 20000 | Rake 0
Seat 2: dimasiktuta (button) collected (20000)
Seat 5: ValeraB96 (small blind) folded before Flop
Seat 6: phpro (big blind) folded before Flop
Seat 7: 7SkYy folded before Flop (didn't bet)
Seat 9: McLci folded before Flop (didn't bet)


*********** # 333 **************
PokerStars Hand #257048628887: Tournament #3910307458, $0.98+$0.12 USD Hold'em No Limit - Level XXX (3200/6400) - 2025/07/22 14:36:24 ET
Table '3910307458 12' 9-max Seat #5 is the button
Seat 2: dimasiktuta (361863 in chips)
Seat 5: ValeraB96 (154190 in chips)
Seat 6: phpro (112488 in chips)
Seat 7: 7SkYy (83734 in chips)
Seat 9: McLci (151725 in chips)
dimasiktuta: posts the ante 800
ValeraB96: posts the ante 800
phpro: posts the ante 800
7SkYy: posts the ante 800
McLci: posts the ante 800
phpro: posts small blind 3200
7SkYy: posts big blind 6400
*** HOLE CARDS ***
Dealt to phpro [3d 7d]
McLci: folds
dimasiktuta: folds
ValeraB96: raises 6400 to 12800
phpro: folds
7SkYy: calls 6400
*** FLOP *** [6d 4h 6s]
7SkYy: checks
ValeraB96: checks
*** TURN *** [6d 4h 6s] [Jh]
7SkYy: checks
ValeraB96: bets 11776
7SkYy: calls 11776
*** RIVER *** [6d 4h 6s Jh] [2h]
7SkYy: bets 12800
ValeraB96: folds
Uncalled bet (12800) returned to 7SkYy
7SkYy collected 56352 from pot
7SkYy: doesn't show hand
*** SUMMARY ***
Total pot 56352 | Rake 0
Board [6d 4h 6s Jh 2h]
Seat 2: dimasiktuta folded before Flop (didn't bet)
Seat 5: ValeraB96 (button) folded on the River
Seat 6: phpro (small blind) folded before Flop
Seat 7: 7SkYy (big blind) collected (56352)
Seat 9: McLci folded before Flop (didn't bet)


*********** # 334 **************
PokerStars Hand #257048643079: Tournament #3910307458, $0.98+$0.12 USD Hold'em No Limit - Level XXX (3200/6400) - 2025/07/22 14:37:32 ET
Table '3910307458 12' 9-max Seat #6 is the button
Seat 2: dimasiktuta (361063 in chips)
Seat 5: ValeraB96 (128814 in chips)
Seat 6: phpro (108488 in chips)
Seat 7: 7SkYy (114710 in chips)
Seat 9: McLci (150925 in chips)
dimasiktuta: posts the ante 800
ValeraB96: posts the ante 800
phpro: posts the ante 800
7SkYy: posts the ante 800
McLci: posts the ante 800
7SkYy: posts small blind 3200
McLci: posts big blind 6400
*** HOLE CARDS ***
Dealt to phpro [3c Jd]
dimasiktuta: raises 6400 to 12800
ValeraB96: folds
phpro: folds
7SkYy: folds
McLci: folds
Uncalled bet (6400) returned to dimasiktuta
dimasiktuta collected 20000 from pot
dimasiktuta: doesn't show hand
*** SUMMARY ***
Total pot 20000 | Rake 0
Seat 2: dimasiktuta collected (20000)
Seat 5: ValeraB96 folded before Flop (didn't bet)
Seat 6: phpro (button) folded before Flop (didn't bet)
Seat 7: 7SkYy (small blind) folded before Flop
Seat 9: McLci (big blind) folded before Flop


*********** # 335 **************
PokerStars Hand #257048646285: Tournament #3910307458, $0.98+$0.12 USD Hold'em No Limit - Level XXX (3200/6400) - 2025/07/22 14:37:47 ET
Table '3910307458 12' 9-max Seat #7 is the button
Seat 2: dimasiktuta (373863 in chips)
Seat 5: ValeraB96 (128014 in chips)
Seat 6: phpro (107688 in chips)
Seat 7: 7SkYy (110710 in chips)
Seat 9: McLci (143725 in chips)
dimasiktuta: posts the ante 800
ValeraB96: posts the ante 800
phpro: posts the ante 800
7SkYy: posts the ante 800
McLci: posts the ante 800
McLci: posts small blind 3200
dimasiktuta: posts big blind 6400
*** HOLE CARDS ***
Dealt to phpro [6d Ac]
ValeraB96: raises 6400 to 12800
phpro: folds
7SkYy: folds
McLci: folds
dimasiktuta: folds
Uncalled bet (6400) returned to ValeraB96
ValeraB96 collected 20000 from pot
ValeraB96: doesn't show hand
*** SUMMARY ***
Total pot 20000 | Rake 0
Seat 2: dimasiktuta (big blind) folded before Flop
Seat 5: ValeraB96 collected (20000)
Seat 6: phpro folded before Flop (didn't bet)
Seat 7: 7SkYy (button) folded before Flop (didn't bet)
Seat 9: McLci (small blind) folded before Flop


*********** # 336 **************
PokerStars Hand #257048652217: Tournament #3910307458, $0.98+$0.12 USD Hold'em No Limit - Level XXX (3200/6400) - 2025/07/22 14:38:15 ET
Table '3910307458 12' 9-max Seat #9 is the button
Seat 2: dimasiktuta (366663 in chips)
Seat 5: ValeraB96 (140814 in chips)
Seat 6: phpro (106888 in chips)
Seat 7: 7SkYy (109910 in chips)
Seat 9: McLci (139725 in chips)
dimasiktuta: posts the ante 800
ValeraB96: posts the ante 800
phpro: posts the ante 800
7SkYy: posts the ante 800
McLci: posts the ante 800
dimasiktuta: posts small blind 3200
ValeraB96: posts big blind 6400
*** HOLE CARDS ***
Dealt to phpro [4s Jh]
phpro: folds
7SkYy: folds
McLci: folds
dimasiktuta: raises 6400 to 12800
ValeraB96: raises 127214 to 140014 and is all-in
dimasiktuta: folds
Uncalled bet (127214) returned to ValeraB96
ValeraB96 collected 29600 from pot
ValeraB96: doesn't show hand
*** SUMMARY ***
Total pot 29600 | Rake 0
Seat 2: dimasiktuta (small blind) folded before Flop
Seat 5: ValeraB96 (big blind) collected (29600)
Seat 6: phpro folded before Flop (didn't bet)
Seat 7: 7SkYy folded before Flop (didn't bet)
Seat 9: McLci (button) folded before Flop (didn't bet)


*********** # 337 **************
PokerStars Hand #257048658132: Tournament #3910307458, $0.98+$0.12 USD Hold'em No Limit - Level XXX (3200/6400) - 2025/07/22 14:38:44 ET
Table '3910307458 12' 9-max Seat #2 is the button
Seat 2: dimasiktuta (353063 in chips)
Seat 5: ValeraB96 (156814 in chips)
Seat 6: phpro (106088 in chips)
Seat 7: 7SkYy (109110 in chips)
Seat 9: McLci (138925 in chips)
dimasiktuta: posts the ante 800
ValeraB96: posts the ante 800
phpro: posts the ante 800
7SkYy: posts the ante 800
McLci: posts the ante 800
ValeraB96: posts small blind 3200
phpro: posts big blind 6400
*** HOLE CARDS ***
Dealt to phpro [4h 4c]
7SkYy: folds
McLci: folds
dimasiktuta: raises 6400 to 12800
ValeraB96: folds
phpro: calls 6400
*** FLOP *** [9d 4d 7c]
phpro: bets 10000
dimasiktuta: calls 10000
*** TURN *** [9d 4d 7c] [3s]
phpro: bets 26400
dimasiktuta: folds
Uncalled bet (26400) returned to phpro
phpro collected 52800 from pot
*** SUMMARY ***
Total pot 52800 | Rake 0
Board [9d 4d 7c 3s]
Seat 2: dimasiktuta (button) folded on the Turn
Seat 5: ValeraB96 (small blind) folded before Flop
Seat 6: phpro (big blind) collected (52800)
Seat 7: 7SkYy folded before Flop (didn't bet)
Seat 9: McLci folded before Flop (didn't bet)


*********** # 338 **************
PokerStars Hand #257048665816: Tournament #3910307458, $0.98+$0.12 USD Hold'em No Limit - Level XXX (3200/6400) - 2025/07/22 14:39:20 ET
Table '3910307458 12' 9-max Seat #5 is the button
Seat 2: dimasiktuta (329463 in chips)
Seat 5: ValeraB96 (152814 in chips)
Seat 6: phpro (135288 in chips)
Seat 7: 7SkYy (108310 in chips)
Seat 9: McLci (138125 in chips)
dimasiktuta: posts the ante 800
ValeraB96: posts the ante 800
phpro: posts the ante 800
7SkYy: posts the ante 800
McLci: posts the ante 800
phpro: posts small blind 3200
7SkYy: posts big blind 6400
*** HOLE CARDS ***
Dealt to phpro [Ts Kh]
McLci: folds
dimasiktuta: raises 6400 to 12800
ValeraB96: folds
phpro: folds
7SkYy: folds
Uncalled bet (6400) returned to dimasiktuta
dimasiktuta collected 20000 from pot
dimasiktuta: doesn't show hand
*** SUMMARY ***
Total pot 20000 | Rake 0
Seat 2: dimasiktuta collected (20000)
Seat 5: ValeraB96 (button) folded before Flop (didn't bet)
Seat 6: phpro (small blind) folded before Flop
Seat 7: 7SkYy (big blind) folded before Flop
Seat 9: McLci folded before Flop (didn't bet)


*********** # 339 **************
PokerStars Hand #257048670471: Tournament #3910307458, $0.98+$0.12 USD Hold'em No Limit - Level XXX (3200/6400) - 2025/07/22 14:39:42 ET
Table '3910307458 12' 9-max Seat #6 is the button
Seat 2: dimasiktuta (342263 in chips)
Seat 5: ValeraB96 (152014 in chips)
Seat 6: phpro (131288 in chips)
Seat 7: 7SkYy (101110 in chips)
Seat 9: McLci (137325 in chips)
dimasiktuta: posts the ante 800
ValeraB96: posts the ante 800
phpro: posts the ante 800
7SkYy: posts the ante 800
McLci: posts the ante 800
7SkYy: posts small blind 3200
McLci: posts big blind 6400
*** HOLE CARDS ***
Dealt to phpro [7h 2h]
dimasiktuta: folds
ValeraB96: raises 6400 to 12800
phpro: folds
7SkYy: folds
McLci: calls 6400
*** FLOP *** [9d Ah Qs]
McLci: checks
ValeraB96: bets 10496
McLci: calls 10496
*** TURN *** [9d Ah Qs] [6s]
McLci: checks
ValeraB96: bets 25600
McLci: folds
Uncalled bet (25600) returned to ValeraB96
ValeraB96 collected 53792 from pot
ValeraB96: doesn't show hand
*** SUMMARY ***
Total pot 53792 | Rake 0
Board [9d Ah Qs 6s]
Seat 2: dimasiktuta folded before Flop (didn't bet)
Seat 5: ValeraB96 collected (53792)
Seat 6: phpro (button) folded before Flop (didn't bet)
Seat 7: 7SkYy (small blind) folded before Flop
Seat 9: McLci (big blind) folded on the Turn


*********** # 340 **************
PokerStars Hand #257048682442: Tournament #3910307458, $0.98+$0.12 USD Hold'em No Limit - Level XXX (3200/6400) - 2025/07/22 14:40:40 ET
Table '3910307458 12' 9-max Seat #7 is the button
Seat 2: dimasiktuta (341463 in chips)
Seat 5: ValeraB96 (181710 in chips)
Seat 6: phpro (130488 in chips)
Seat 7: 7SkYy (97110 in chips)
Seat 9: McLci (113229 in chips)
dimasiktuta: posts the ante 800
ValeraB96: posts the ante 800
phpro: posts the ante 800
7SkYy: posts the ante 800
McLci: posts the ante 800
McLci: posts small blind 3200
dimasiktuta: posts big blind 6400
*** HOLE CARDS ***
Dealt to phpro [6c 4c]
ValeraB96: folds
phpro: folds
7SkYy: folds
McLci: folds
Uncalled bet (3200) returned to dimasiktuta
dimasiktuta collected 10400 from pot
dimasiktuta: doesn't show hand
*** SUMMARY ***
Total pot 10400 | Rake 0
Seat 2: dimasiktuta (big blind) collected (10400)
Seat 5: ValeraB96 folded before Flop (didn't bet)
Seat 6: phpro folded before Flop (didn't bet)
Seat 7: 7SkYy (button) folded before Flop (didn't bet)
Seat 9: McLci (small blind) folded before Flop


*********** # 341 **************
PokerStars Hand #257048685134: Tournament #3910307458, $0.98+$0.12 USD Hold'em No Limit - Level XXX (3200/6400) - 2025/07/22 14:40:52 ET
Table '3910307458 12' 9-max Seat #9 is the button
Seat 2: dimasiktuta (347863 in chips)
Seat 5: ValeraB96 (180910 in chips)
Seat 6: phpro (129688 in chips)
Seat 7: 7SkYy (96310 in chips)
Seat 9: McLci (109229 in chips)
dimasiktuta: posts the ante 800
ValeraB96: posts the ante 800
phpro: posts the ante 800
7SkYy: posts the ante 800
McLci: posts the ante 800
dimasiktuta: posts small blind 3200
ValeraB96: posts big blind 6400
*** HOLE CARDS ***
Dealt to phpro [3h Ks]
phpro: folds
7SkYy: raises 6400 to 12800
McLci: folds
dimasiktuta: folds
ValeraB96: calls 6400
*** FLOP *** [5h 7c Jh]
ValeraB96: checks
7SkYy: checks
*** TURN *** [5h 7c Jh] [3s]
ValeraB96: bets 16896
7SkYy: folds
Uncalled bet (16896) returned to ValeraB96
ValeraB96 collected 32800 from pot
ValeraB96: doesn't show hand
*** SUMMARY ***
Total pot 32800 | Rake 0
Board [5h 7c Jh 3s]
Seat 2: dimasiktuta (small blind) folded before Flop
Seat 5: ValeraB96 (big blind) collected (32800)
Seat 6: phpro folded before Flop (didn't bet)
Seat 7: 7SkYy folded on the Turn
Seat 9: McLci (button) folded before Flop (didn't bet)


*********** # 342 **************
PokerStars Hand #257048692293: Tournament #3910307458, $0.98+$0.12 USD Hold'em No Limit - Level XXX (3200/6400) - 2025/07/22 14:41:27 ET
Table '3910307458 12' 9-max Seat #2 is the button
Seat 2: dimasiktuta (343863 in chips)
Seat 5: ValeraB96 (200110 in chips)
Seat 6: phpro (128888 in chips)
Seat 7: 7SkYy (82710 in chips)
Seat 9: McLci (108429 in chips)
dimasiktuta: posts the ante 800
ValeraB96: posts the ante 800
phpro: posts the ante 800
7SkYy: posts the ante 800
McLci: posts the ante 800
ValeraB96: posts small blind 3200
phpro: posts big blind 6400
*** HOLE CARDS ***
Dealt to phpro [4s 6d]
7SkYy: folds
McLci: folds
dimasiktuta: folds
ValeraB96: calls 3200
phpro: checks
*** FLOP *** [6c 5c 8h]
ValeraB96: bets 6400
phpro: calls 6400
*** TURN *** [6c 5c 8h] [Ts]
ValeraB96: bets 9472
phpro: calls 9472
*** RIVER *** [6c 5c 8h Ts] [Qc]
ValeraB96: bets 12136
phpro: folds
Uncalled bet (12136) returned to ValeraB96
ValeraB96 collected 48544 from pot
ValeraB96: doesn't show hand
*** SUMMARY ***
Total pot 48544 | Rake 0
Board [6c 5c 8h Ts Qc]
Seat 2: dimasiktuta (button) folded before Flop (didn't bet)
Seat 5: ValeraB96 (small blind) collected (48544)
Seat 6: phpro (big blind) folded on the River
Seat 7: 7SkYy folded before Flop (didn't bet)
Seat 9: McLci folded before Flop (didn't bet)


*********** # 343 **************
PokerStars Hand #257048702110: Tournament #3910307458, $0.98+$0.12 USD Hold'em No Limit - Level XXX (3200/6400) - 2025/07/22 14:42:14 ET
Table '3910307458 12' 9-max Seat #5 is the button
Seat 2: dimasiktuta (343063 in chips)
Seat 5: ValeraB96 (225582 in chips)
Seat 6: phpro (105816 in chips)
Seat 7: 7SkYy (81910 in chips)
Seat 9: McLci (107629 in chips)
dimasiktuta: posts the ante 800
ValeraB96: posts the ante 800
phpro: posts the ante 800
7SkYy: posts the ante 800
McLci: posts the ante 800
phpro: posts small blind 3200
7SkYy: posts big blind 6400
*** HOLE CARDS ***
Dealt to phpro [2c 8d]
McLci: folds
dimasiktuta: folds
ValeraB96: raises 6400 to 12800
phpro: folds
7SkYy: folds
Uncalled bet (6400) returned to ValeraB96
ValeraB96 collected 20000 from pot
ValeraB96: doesn't show hand
*** SUMMARY ***
Total pot 20000 | Rake 0
Seat 2: dimasiktuta folded before Flop (didn't bet)
Seat 5: ValeraB96 (button) collected (20000)
Seat 6: phpro (small blind) folded before Flop
Seat 7: 7SkYy (big blind) folded before Flop
Seat 9: McLci folded before Flop (didn't bet)


*********** # 344 **************
PokerStars Hand #257048705582: Tournament #3910307458, $0.98+$0.12 USD Hold'em No Limit - Level XXX (3200/6400) - 2025/07/22 14:42:30 ET
Table '3910307458 12' 9-max Seat #6 is the button
Seat 2: dimasiktuta (342263 in chips)
Seat 5: ValeraB96 (238382 in chips)
Seat 6: phpro (101816 in chips)
Seat 7: 7SkYy (74710 in chips)
Seat 9: McLci (106829 in chips)
dimasiktuta: posts the ante 800
ValeraB96: posts the ante 800
phpro: posts the ante 800
7SkYy: posts the ante 800
McLci: posts the ante 800
7SkYy: posts small blind 3200
McLci: posts big blind 6400
*** HOLE CARDS ***
Dealt to phpro [2d 5h]
dimasiktuta: folds
ValeraB96: folds
phpro: folds
7SkYy: calls 3200
McLci: checks
*** FLOP *** [7h Kc 2c]
7SkYy: bets 6400
McLci: folds
Uncalled bet (6400) returned to 7SkYy
7SkYy collected 16800 from pot
7SkYy: doesn't show hand
*** SUMMARY ***
Total pot 16800 | Rake 0
Board [7h Kc 2c]
Seat 2: dimasiktuta folded before Flop (didn't bet)
Seat 5: ValeraB96 folded before Flop (didn't bet)
Seat 6: phpro (button) folded before Flop (didn't bet)
Seat 7: 7SkYy (small blind) collected (16800)
Seat 9: McLci (big blind) folded on the Flop


*********** # 345 **************
PokerStars Hand #257048709405: Tournament #3910307458, $0.98+$0.12 USD Hold'em No Limit - Level XXX (3200/6400) - 2025/07/22 14:42:49 ET
Table '3910307458 12' 9-max Seat #7 is the button
Seat 2: dimasiktuta (341463 in chips)
Seat 5: ValeraB96 (237582 in chips)
Seat 6: phpro (101016 in chips)
Seat 7: 7SkYy (84310 in chips)
Seat 9: McLci (99629 in chips)
dimasiktuta: posts the ante 800
ValeraB96: posts the ante 800
phpro: posts the ante 800
7SkYy: posts the ante 800
McLci: posts the ante 800
McLci: posts small blind 3200
dimasiktuta: posts big blind 6400
*** HOLE CARDS ***
Dealt to phpro [Qh 9s]
ValeraB96: raises 6400 to 12800
phpro: folds
7SkYy: folds
McLci: folds
dimasiktuta: folds
Uncalled bet (6400) returned to ValeraB96
ValeraB96 collected 20000 from pot
ValeraB96: doesn't show hand
*** SUMMARY ***
Total pot 20000 | Rake 0
Seat 2: dimasiktuta (big blind) folded before Flop
Seat 5: ValeraB96 collected (20000)
Seat 6: phpro folded before Flop (didn't bet)
Seat 7: 7SkYy (button) folded before Flop (didn't bet)
Seat 9: McLci (small blind) folded before Flop


*********** # 346 **************
PokerStars Hand #257048713379: Tournament #3910307458, $0.98+$0.12 USD Hold'em No Limit - Level XXX (3200/6400) - 2025/07/22 14:43:08 ET
Table '3910307458 12' 9-max Seat #9 is the button
Seat 2: dimasiktuta (334263 in chips)
Seat 5: ValeraB96 (250382 in chips)
Seat 6: phpro (100216 in chips)
Seat 7: 7SkYy (83510 in chips)
Seat 9: McLci (95629 in chips)
dimasiktuta: posts the ante 800
ValeraB96: posts the ante 800
phpro: posts the ante 800
7SkYy: posts the ante 800
McLci: posts the ante 800
dimasiktuta: posts small blind 3200
ValeraB96: posts big blind 6400
*** HOLE CARDS ***
Dealt to phpro [3s Jc]
phpro: folds
7SkYy: folds
McLci: folds
dimasiktuta: raises 12800 to 19200
ValeraB96: calls 12800
*** FLOP *** [2h 8s 5c]
dimasiktuta: bets 19200
ValeraB96: calls 19200
*** TURN *** [2h 8s 5c] [Qs]
dimasiktuta: bets 32000
phpro is disconnected
ValeraB96: folds
Uncalled bet (32000) returned to dimasiktuta
dimasiktuta collected 80800 from pot
dimasiktuta: doesn't show hand
*** SUMMARY ***
Total pot 80800 | Rake 0
Board [2h 8s 5c Qs]
Seat 2: dimasiktuta (small blind) collected (80800)
Seat 5: ValeraB96 (big blind) folded on the Turn
Seat 6: phpro folded before Flop (didn't bet)
Seat 7: 7SkYy folded before Flop (didn't bet)
Seat 9: McLci (button) folded before Flop (didn't bet)


*********** # 347 **************
PokerStars Hand #257048719856: Tournament #3910307458, $0.98+$0.12 USD Hold'em No Limit - Level XXX (3200/6400) - 2025/07/22 14:43:39 ET
Table '3910307458 12' 9-max Seat #2 is the button
Seat 2: dimasiktuta (375863 in chips)
Seat 5: ValeraB96 (211182 in chips)
Seat 6: phpro (99416 in chips)
Seat 7: 7SkYy (82710 in chips)
Seat 9: McLci (94829 in chips)
dimasiktuta: posts the ante 800
ValeraB96: posts the ante 800
phpro: posts the ante 800
7SkYy: posts the ante 800
McLci: posts the ante 800
ValeraB96: posts small blind 3200
phpro: posts big blind 6400
*** HOLE CARDS ***
Dealt to phpro [Ts Ah]
7SkYy: raises 6400 to 12800
McLci: folds
dimasiktuta: folds
ValeraB96: calls 9600
phpro is connected
phpro is disconnected
phpro is connected
phpro: calls 6400
*** FLOP *** [9c 8c 5h]
ValeraB96: checks
phpro: checks
7SkYy: bets 69110 and is all-in
ValeraB96: folds
phpro: folds
Uncalled bet (69110) returned to 7SkYy
7SkYy collected 42400 from pot
7SkYy: doesn't show hand
*** SUMMARY ***
Total pot 42400 | Rake 0
Board [9c 8c 5h]
Seat 2: dimasiktuta (button) folded before Flop (didn't bet)
Seat 5: ValeraB96 (small blind) folded on the Flop
Seat 6: phpro (big blind) folded on the Flop
Seat 7: 7SkYy collected (42400)
Seat 9: McLci folded before Flop (didn't bet)


*********** # 348 **************
PokerStars Hand #257048740033: Tournament #3910307458, $0.98+$0.12 USD Hold'em No Limit - Level XXX (3200/6400) - 2025/07/22 14:45:15 ET
Table '3910307458 12' 9-max Seat #5 is the button
Seat 2: dimasiktuta (375063 in chips)
Seat 5: ValeraB96 (197582 in chips)
Seat 6: phpro (85816 in chips)
Seat 7: 7SkYy (111510 in chips)
Seat 9: McLci (94029 in chips)
dimasiktuta: posts the ante 800
ValeraB96: posts the ante 800
phpro: posts the ante 800
7SkYy: posts the ante 800
McLci: posts the ante 800
phpro: posts small blind 3200
7SkYy: posts big blind 6400
*** HOLE CARDS ***
Dealt to phpro [4s 9c]
McLci: raises 6400 to 12800
dimasiktuta: calls 12800
ValeraB96: folds
phpro: folds
7SkYy: calls 6400
*** FLOP *** [3h 9d 8s]
7SkYy: checks
McLci: checks
dimasiktuta: checks
*** TURN *** [3h 9d 8s] [5c]
7SkYy: checks
McLci: checks
dimasiktuta: checks
*** RIVER *** [3h 9d 8s 5c] [Qs]
7SkYy: bets 6400
McLci: raises 25600 to 32000
dimasiktuta: raises 69600 to 101600
7SkYy: folds
McLci: calls 48429 and is all-in
Uncalled bet (21171) returned to dimasiktuta
*** SHOW DOWN ***
dimasiktuta: shows [Td Jd] (a straight, Eight to Queen)
McLci: shows [Ac Qd] (a pair of Queens)
dimasiktuta collected 212858 from pot
McLci finished the tournament in 5th place and received $14.55.
*** SUMMARY ***
Total pot 212858 | Rake 0
Board [3h 9d 8s 5c Qs]
Seat 2: dimasiktuta showed [Td Jd] and won (212858) with a straight, Eight to Queen
Seat 5: ValeraB96 (button) folded before Flop (didn't bet)
Seat 6: phpro (small blind) folded before Flop
Seat 7: 7SkYy (big blind) folded on the River
Seat 9: McLci showed [Ac Qd] and lost with a pair of Queens


*********** # 349 **************
PokerStars Hand #257048756742: Tournament #3910307458, $0.98+$0.12 USD Hold'em No Limit - Level XXXI (3600/7200) - 2025/07/22 14:46:34 ET
Table '3910307458 12' 9-max Seat #6 is the button
Seat 2: dimasiktuta (493892 in chips)
Seat 5: ValeraB96 (196782 in chips)
Seat 6: phpro (81816 in chips)
Seat 7: 7SkYy (91510 in chips)
dimasiktuta: posts the ante 900
ValeraB96: posts the ante 900
phpro: posts the ante 900
7SkYy: posts the ante 900
7SkYy: posts small blind 3600
dimasiktuta: posts big blind 7200
*** HOLE CARDS ***
Dealt to phpro [8s As]
ValeraB96: folds
phpro: raises 7200 to 14400
7SkYy: folds
dimasiktuta: folds
Uncalled bet (7200) returned to phpro
phpro collected 21600 from pot
*** SUMMARY ***
Total pot 21600 | Rake 0
Seat 2: dimasiktuta (big blind) folded before Flop
Seat 5: ValeraB96 folded before Flop (didn't bet)
Seat 6: phpro (button) collected (21600)
Seat 7: 7SkYy (small blind) folded before Flop


*********** # 350 **************
PokerStars Hand #257048760296: Tournament #3910307458, $0.98+$0.12 USD Hold'em No Limit - Level XXXI (3600/7200) - 2025/07/22 14:46:51 ET
Table '3910307458 12' 9-max Seat #7 is the button
Seat 2: dimasiktuta (485792 in chips)
Seat 5: ValeraB96 (195882 in chips)
Seat 6: phpro (95316 in chips)
Seat 7: 7SkYy (87010 in chips)
dimasiktuta: posts the ante 900
ValeraB96: posts the ante 900
phpro: posts the ante 900
7SkYy: posts the ante 900
dimasiktuta: posts small blind 3600
ValeraB96: posts big blind 7200
*** HOLE CARDS ***
Dealt to phpro [7c Td]
phpro: folds
7SkYy: raises 7200 to 14400
dimasiktuta: folds
ValeraB96: folds
Uncalled bet (7200) returned to 7SkYy
7SkYy collected 21600 from pot
7SkYy: doesn't show hand
*** SUMMARY ***
Total pot 21600 | Rake 0
Seat 2: dimasiktuta (small blind) folded before Flop
Seat 5: ValeraB96 (big blind) folded before Flop
Seat 6: phpro folded before Flop (didn't bet)
Seat 7: 7SkYy (button) collected (21600)


*********** # 351 **************
PokerStars Hand #257048763646: Tournament #3910307458, $0.98+$0.12 USD Hold'em No Limit - Level XXXI (3600/7200) - 2025/07/22 14:47:07 ET
Table '3910307458 12' 9-max Seat #2 is the button
Seat 2: dimasiktuta (481292 in chips)
Seat 5: ValeraB96 (187782 in chips)
Seat 6: phpro (94416 in chips)
Seat 7: 7SkYy (100510 in chips)
dimasiktuta: posts the ante 900
ValeraB96: posts the ante 900
phpro: posts the ante 900
7SkYy: posts the ante 900
ValeraB96: posts small blind 3600
phpro: posts big blind 7200
*** HOLE CARDS ***
Dealt to phpro [2h Jh]
7SkYy: raises 7200 to 14400
dimasiktuta: folds
ValeraB96: folds
phpro: folds
Uncalled bet (7200) returned to 7SkYy
7SkYy collected 21600 from pot
7SkYy: doesn't show hand
*** SUMMARY ***
Total pot 21600 | Rake 0
Seat 2: dimasiktuta (button) folded before Flop (didn't bet)
Seat 5: ValeraB96 (small blind) folded before Flop
Seat 6: phpro (big blind) folded before Flop
Seat 7: 7SkYy collected (21600)


*********** # 352 **************
PokerStars Hand #257048767607: Tournament #3910307458, $0.98+$0.12 USD Hold'em No Limit - Level XXXI (3600/7200) - 2025/07/22 14:47:26 ET
Table '3910307458 12' 9-max Seat #5 is the button
Seat 2: dimasiktuta (480392 in chips)
Seat 5: ValeraB96 (183282 in chips)
Seat 6: phpro (86316 in chips)
Seat 7: 7SkYy (114010 in chips)
dimasiktuta: posts the ante 900
ValeraB96: posts the ante 900
phpro: posts the ante 900
7SkYy: posts the ante 900
phpro: posts small blind 3600
7SkYy: posts big blind 7200
*** HOLE CARDS ***
Dealt to phpro [Kc 6s]
dimasiktuta: folds
ValeraB96: folds
phpro: raises 7200 to 14400
7SkYy: folds
Uncalled bet (7200) returned to phpro
phpro collected 18000 from pot
*** SUMMARY ***
Total pot 18000 | Rake 0
Seat 2: dimasiktuta folded before Flop (didn't bet)
Seat 5: ValeraB96 (button) folded before Flop (didn't bet)
Seat 6: phpro (small blind) collected (18000)
Seat 7: 7SkYy (big blind) folded before Flop


*********** # 353 **************
PokerStars Hand #257048771414: Tournament #3910307458, $0.98+$0.12 USD Hold'em No Limit - Level XXXI (3600/7200) - 2025/07/22 14:47:44 ET
Table '3910307458 12' 9-max Seat #6 is the button
Seat 2: dimasiktuta (479492 in chips)
Seat 5: ValeraB96 (182382 in chips)
Seat 6: phpro (96216 in chips)
Seat 7: 7SkYy (105910 in chips)
dimasiktuta: posts the ante 900
ValeraB96: posts the ante 900
phpro: posts the ante 900
7SkYy: posts the ante 900
7SkYy: posts small blind 3600
dimasiktuta: posts big blind 7200
*** HOLE CARDS ***
Dealt to phpro [7d Kd]
ValeraB96: folds
phpro: raises 7200 to 14400
7SkYy: folds
dimasiktuta: raises 464192 to 478592 and is all-in
phpro: folds
Uncalled bet (464192) returned to dimasiktuta
dimasiktuta collected 36000 from pot
dimasiktuta: doesn't show hand
*** SUMMARY ***
Total pot 36000 | Rake 0
Seat 2: dimasiktuta (big blind) collected (36000)
Seat 5: ValeraB96 folded before Flop (didn't bet)
Seat 6: phpro (button) folded before Flop
Seat 7: 7SkYy (small blind) folded before Flop


*********** # 354 **************
PokerStars Hand #257048775902: Tournament #3910307458, $0.98+$0.12 USD Hold'em No Limit - Level XXXI (3600/7200) - 2025/07/22 14:48:05 ET
Table '3910307458 12' 9-max Seat #7 is the button
Seat 2: dimasiktuta (500192 in chips)
Seat 5: ValeraB96 (181482 in chips)
Seat 6: phpro (80916 in chips)
Seat 7: 7SkYy (101410 in chips)
dimasiktuta: posts the ante 900
ValeraB96: posts the ante 900
phpro: posts the ante 900
7SkYy: posts the ante 900
dimasiktuta: posts small blind 3600
ValeraB96: posts big blind 7200
*** HOLE CARDS ***
Dealt to phpro [Qd 9c]
phpro: folds
7SkYy: raises 7200 to 14400
dimasiktuta: folds
ValeraB96: calls 7200
*** FLOP *** [6d 9h 4h]
ValeraB96: checks
7SkYy: checks
*** TURN *** [6d 9h 4h] [As]
ValeraB96: checks
7SkYy: bets 15480
ValeraB96: calls 15480
*** RIVER *** [6d 9h 4h As] [3s]
ValeraB96: checks
7SkYy: checks
*** SHOW DOWN ***
ValeraB96: shows [7c 8s] (high card Ace)
7SkYy: shows [Kd Tc] (high card Ace - King kicker)
7SkYy collected 66960 from pot
*** SUMMARY ***
Total pot 66960 | Rake 0
Board [6d 9h 4h As 3s]
Seat 2: dimasiktuta (small blind) folded before Flop
Seat 5: ValeraB96 (big blind) showed [7c 8s] and lost with high card Ace
Seat 6: phpro folded before Flop (didn't bet)
Seat 7: 7SkYy (button) showed [Kd Tc] and won (66960) with high card Ace


*********** # 355 **************
PokerStars Hand #257048783393: Tournament #3910307458, $0.98+$0.12 USD Hold'em No Limit - Level XXXI (3600/7200) - 2025/07/22 14:48:40 ET
Table '3910307458 12' 9-max Seat #2 is the button
Seat 2: dimasiktuta (495692 in chips)
Seat 5: ValeraB96 (150702 in chips)
Seat 6: phpro (80016 in chips)
Seat 7: 7SkYy (137590 in chips)
dimasiktuta: posts the ante 900
ValeraB96: posts the ante 900
phpro: posts the ante 900
7SkYy: posts the ante 900
ValeraB96: posts small blind 3600
phpro: posts big blind 7200
*** HOLE CARDS ***
Dealt to phpro [3h 5h]
phpro is disconnected
7SkYy: folds
dimasiktuta: folds
ValeraB96: raises 7200 to 14400
phpro has timed out while disconnected
phpro: folds
Uncalled bet (7200) returned to ValeraB96
ValeraB96 collected 18000 from pot
ValeraB96: doesn't show hand
*** SUMMARY ***
Total pot 18000 | Rake 0
Seat 2: dimasiktuta (button) folded before Flop (didn't bet)
Seat 5: ValeraB96 (small blind) collected (18000)
Seat 6: phpro (big blind) folded before Flop
Seat 7: 7SkYy folded before Flop (didn't bet)


*********** # 356 **************
PokerStars Hand #257048794995: Tournament #3910307458, $0.98+$0.12 USD Hold'em No Limit - Level XXXI (3600/7200) - 2025/07/22 14:49:35 ET
Table '3910307458 12' 9-max Seat #5 is the button
Seat 2: dimasiktuta (494792 in chips)
Seat 5: ValeraB96 (160602 in chips)
Seat 6: phpro (71916 in chips)
Seat 7: 7SkYy (136690 in chips)
dimasiktuta: posts the ante 900
ValeraB96: posts the ante 900
phpro: posts the ante 900
7SkYy: posts the ante 900
phpro: posts small blind 3600
7SkYy: posts big blind 7200
*** HOLE CARDS ***
Dealt to phpro [2s Jc]
phpro is disconnected
dimasiktuta: raises 7200 to 14400
ValeraB96: folds
phpro: folds
7SkYy: calls 7200
*** FLOP *** [5s Tc 4s]
7SkYy: checks
dimasiktuta: bets 8640
7SkYy: calls 8640
*** TURN *** [5s Tc 4s] [Th]
7SkYy: checks
dimasiktuta: bets 21600
7SkYy: folds
Uncalled bet (21600) returned to dimasiktuta
dimasiktuta collected 53280 from pot
dimasiktuta: doesn't show hand
*** SUMMARY ***
Total pot 53280 | Rake 0
Board [5s Tc 4s Th]
Seat 2: dimasiktuta collected (53280)
Seat 5: ValeraB96 (button) folded before Flop (didn't bet)
Seat 6: phpro (small blind) folded before Flop
Seat 7: 7SkYy (big blind) folded on the Turn


*********** # 357 **************
PokerStars Hand #257048805739: Tournament #3910307458, $0.98+$0.12 USD Hold'em No Limit - Level XXXI (3600/7200) - 2025/07/22 14:50:26 ET
Table '3910307458 12' 9-max Seat #6 is the button
Seat 2: dimasiktuta (524132 in chips)
Seat 5: ValeraB96 (159702 in chips)
Seat 6: phpro (67416 in chips)
Seat 7: 7SkYy (112750 in chips)
dimasiktuta: posts the ante 900
ValeraB96: posts the ante 900
phpro: posts the ante 900
7SkYy: posts the ante 900
7SkYy: posts small blind 3600
dimasiktuta: posts big blind 7200
*** HOLE CARDS ***
Dealt to phpro [Kc 9d]
ValeraB96: folds
phpro: raises 7200 to 14400
7SkYy: folds
dimasiktuta: folds
Uncalled bet (7200) returned to phpro
phpro collected 21600 from pot
*** SUMMARY ***
Total pot 21600 | Rake 0
Seat 2: dimasiktuta (big blind) folded before Flop
Seat 5: ValeraB96 folded before Flop (didn't bet)
Seat 6: phpro (button) collected (21600)
Seat 7: 7SkYy (small blind) folded before Flop


*********** # 358 **************
PokerStars Hand #257048809284: Tournament #3910307458, $0.98+$0.12 USD Hold'em No Limit - Level XXXI (3600/7200) - 2025/07/22 14:50:43 ET
Table '3910307458 12' 9-max Seat #7 is the button
Seat 2: dimasiktuta (516032 in chips)
Seat 5: ValeraB96 (158802 in chips)
Seat 6: phpro (80916 in chips)
Seat 7: 7SkYy (108250 in chips)
dimasiktuta: posts the ante 900
ValeraB96: posts the ante 900
phpro: posts the ante 900
7SkYy: posts the ante 900
dimasiktuta: posts small blind 3600
ValeraB96: posts big blind 7200
*** HOLE CARDS ***
Dealt to phpro [6h Ks]
phpro: folds
7SkYy: raises 7200 to 14400
dimasiktuta: folds
ValeraB96: calls 7200
*** FLOP *** [Ad 4c Kc]
ValeraB96: checks
7SkYy: bets 11880
ValeraB96: raises 16920 to 28800
7SkYy: raises 64150 to 92950 and is all-in
ValeraB96: folds
Uncalled bet (64150) returned to 7SkYy
7SkYy collected 93600 from pot
7SkYy: doesn't show hand
*** SUMMARY ***
Total pot 93600 | Rake 0
Board [Ad 4c Kc]
Seat 2: dimasiktuta (small blind) folded before Flop
Seat 5: ValeraB96 (big blind) folded on the Flop
Seat 6: phpro folded before Flop (didn't bet)
Seat 7: 7SkYy (button) collected (93600)


*********** # 359 **************
PokerStars Hand #257048818457: Tournament #3910307458, $0.98+$0.12 USD Hold'em No Limit - Level XXXI (3600/7200) - 2025/07/22 14:51:26 ET
Table '3910307458 12' 9-max Seat #2 is the button
Seat 2: dimasiktuta (511532 in chips)
Seat 5: ValeraB96 (114702 in chips)
Seat 6: phpro (80016 in chips)
Seat 7: 7SkYy (157750 in chips)
dimasiktuta: posts the ante 900
ValeraB96: posts the ante 900
phpro: posts the ante 900
7SkYy: posts the ante 900
ValeraB96: posts small blind 3600
phpro: posts big blind 7200
*** HOLE CARDS ***
Dealt to phpro [9d 6h]
7SkYy: folds
dimasiktuta: raises 7200 to 14400
ValeraB96: folds
phpro: folds
Uncalled bet (7200) returned to dimasiktuta
dimasiktuta collected 21600 from pot
dimasiktuta: doesn't show hand
*** SUMMARY ***
Total pot 21600 | Rake 0
Seat 2: dimasiktuta (button) collected (21600)
Seat 5: ValeraB96 (small blind) folded before Flop
Seat 6: phpro (big blind) folded before Flop
Seat 7: 7SkYy folded before Flop (didn't bet)


*********** # 360 **************
PokerStars Hand #257048821443: Tournament #3910307458, $0.98+$0.12 USD Hold'em No Limit - Level XXXI (3600/7200) - 2025/07/22 14:51:40 ET
Table '3910307458 12' 9-max Seat #5 is the button
Seat 2: dimasiktuta (525032 in chips)
Seat 5: ValeraB96 (110202 in chips)
Seat 6: phpro (71916 in chips)
Seat 7: 7SkYy (156850 in chips)
dimasiktuta: posts the ante 900
ValeraB96: posts the ante 900
phpro: posts the ante 900
7SkYy: posts the ante 900
phpro: posts small blind 3600
7SkYy: posts big blind 7200
*** HOLE CARDS ***
Dealt to phpro [6s 2s]
dimasiktuta: folds
ValeraB96: raises 102102 to 109302 and is all-in
phpro: folds
7SkYy: folds
Uncalled bet (102102) returned to ValeraB96
ValeraB96 collected 21600 from pot
ValeraB96: doesn't show hand
*** SUMMARY ***
Total pot 21600 | Rake 0
Seat 2: dimasiktuta folded before Flop (didn't bet)
Seat 5: ValeraB96 (button) collected (21600)
Seat 6: phpro (small blind) folded before Flop
Seat 7: 7SkYy (big blind) folded before Flop


*********** # 361 **************
PokerStars Hand #257048825009: Tournament #3910307458, $0.98+$0.12 USD Hold'em No Limit - Level XXXI (3600/7200) - 2025/07/22 14:51:57 ET
Table '3910307458 12' 9-max Seat #6 is the button
Seat 2: dimasiktuta (524132 in chips)
Seat 5: ValeraB96 (123702 in chips)
Seat 6: phpro (67416 in chips)
Seat 7: 7SkYy (148750 in chips)
dimasiktuta: posts the ante 900
ValeraB96: posts the ante 900
phpro: posts the ante 900
7SkYy: posts the ante 900
7SkYy: posts small blind 3600
dimasiktuta: posts big blind 7200
*** HOLE CARDS ***
Dealt to phpro [Qh 6d]
ValeraB96: folds
phpro: folds
7SkYy: calls 3600
dimasiktuta: checks
*** FLOP *** [2c 7c Ac]
7SkYy: bets 7200
dimasiktuta: folds
Uncalled bet (7200) returned to 7SkYy
7SkYy collected 18000 from pot
7SkYy: doesn't show hand
*** SUMMARY ***
Total pot 18000 | Rake 0
Board [2c 7c Ac]
Seat 2: dimasiktuta (big blind) folded on the Flop
Seat 5: ValeraB96 folded before Flop (didn't bet)
Seat 6: phpro (button) folded before Flop (didn't bet)
Seat 7: 7SkYy (small blind) collected (18000)


*********** # 362 **************
PokerStars Hand #257048829079: Tournament #3910307458, $0.98+$0.12 USD Hold'em No Limit - Level XXXI (3600/7200) - 2025/07/22 14:52:16 ET
Table '3910307458 12' 9-max Seat #7 is the button
Seat 2: dimasiktuta (516032 in chips)
Seat 5: ValeraB96 (122802 in chips)
Seat 6: phpro (66516 in chips)
Seat 7: 7SkYy (158650 in chips)
dimasiktuta: posts the ante 900
ValeraB96: posts the ante 900
phpro: posts the ante 900
7SkYy: posts the ante 900
dimasiktuta: posts small blind 3600
ValeraB96: posts big blind 7200
*** HOLE CARDS ***
Dealt to phpro [9c 3h]
phpro: folds
7SkYy: folds
dimasiktuta: raises 7200 to 14400
ValeraB96: raises 107502 to 121902 and is all-in
dimasiktuta: folds
Uncalled bet (107502) returned to ValeraB96
ValeraB96 collected 32400 from pot
ValeraB96: doesn't show hand
*** SUMMARY ***
Total pot 32400 | Rake 0
Seat 2: dimasiktuta (small blind) folded before Flop
Seat 5: ValeraB96 (big blind) collected (32400)
Seat 6: phpro folded before Flop (didn't bet)
Seat 7: 7SkYy (button) folded before Flop (didn't bet)


*********** # 363 **************
PokerStars Hand #257048833200: Tournament #3910307458, $0.98+$0.12 USD Hold'em No Limit - Level XXXI (3600/7200) - 2025/07/22 14:52:36 ET
Table '3910307458 12' 9-max Seat #2 is the button
Seat 2: dimasiktuta (500732 in chips)
Seat 5: ValeraB96 (139902 in chips)
Seat 6: phpro (65616 in chips)
Seat 7: 7SkYy (157750 in chips)
dimasiktuta: posts the ante 900
ValeraB96: posts the ante 900
phpro: posts the ante 900
7SkYy: posts the ante 900
ValeraB96: posts small blind 3600
phpro: posts big blind 7200
*** HOLE CARDS ***
Dealt to phpro [3s Qh]
7SkYy: raises 7200 to 14400
dimasiktuta: calls 14400
ValeraB96: folds
phpro: folds
*** FLOP *** [7s 5d Qc]
7SkYy: checks
dimasiktuta: checks
*** TURN *** [7s 5d Qc] [Jh]
7SkYy: checks
dimasiktuta: bets 14400
7SkYy: folds
Uncalled bet (14400) returned to dimasiktuta
dimasiktuta collected 43200 from pot
dimasiktuta: doesn't show hand
*** SUMMARY ***
Total pot 43200 | Rake 0
Board [7s 5d Qc Jh]
Seat 2: dimasiktuta (button) collected (43200)
Seat 5: ValeraB96 (small blind) folded before Flop
Seat 6: phpro (big blind) folded before Flop
Seat 7: 7SkYy folded on the Turn


*********** # 364 **************
PokerStars Hand #257048841498: Tournament #3910307458, $0.98+$0.12 USD Hold'em No Limit - Level XXXI (3600/7200) - 2025/07/22 14:53:16 ET
Table '3910307458 12' 9-max Seat #5 is the button
Seat 2: dimasiktuta (528632 in chips)
Seat 5: ValeraB96 (135402 in chips)
Seat 6: phpro (57516 in chips)
Seat 7: 7SkYy (142450 in chips)
dimasiktuta: posts the ante 900
ValeraB96: posts the ante 900
phpro: posts the ante 900
7SkYy: posts the ante 900
phpro: posts small blind 3600
7SkYy: posts big blind 7200
*** HOLE CARDS ***
Dealt to phpro [Td 2h]
dimasiktuta: folds
ValeraB96: raises 7200 to 14400
phpro: folds
7SkYy: calls 7200
*** FLOP *** [6h Jc Jh]
7SkYy: checks
ValeraB96: bets 11520
7SkYy: raises 18720 to 30240
ValeraB96: calls 18720
*** TURN *** [6h Jc Jh] [8h]
7SkYy: bets 9360
ValeraB96: raises 44064 to 53424
7SkYy: folds
Uncalled bet (44064) returned to ValeraB96
ValeraB96 collected 115200 from pot
ValeraB96: doesn't show hand
*** SUMMARY ***
Total pot 115200 | Rake 0
Board [6h Jc Jh 8h]
Seat 2: dimasiktuta folded before Flop (didn't bet)
Seat 5: ValeraB96 (button) collected (115200)
Seat 6: phpro (small blind) folded before Flop
Seat 7: 7SkYy (big blind) folded on the Turn


*********** # 365 **************
PokerStars Hand #257048851115: Tournament #3910307458, $0.98+$0.12 USD Hold'em No Limit - Level XXXI (3600/7200) - 2025/07/22 14:54:00 ET
Table '3910307458 12' 9-max Seat #6 is the button
Seat 2: dimasiktuta (527732 in chips)
Seat 5: ValeraB96 (195702 in chips)
Seat 6: phpro (53016 in chips)
Seat 7: 7SkYy (87550 in chips)
dimasiktuta: posts the ante 900
ValeraB96: posts the ante 900
phpro: posts the ante 900
7SkYy: posts the ante 900
7SkYy: posts small blind 3600
dimasiktuta: posts big blind 7200
*** HOLE CARDS ***
Dealt to phpro [Kd Js]
ValeraB96: raises 7200 to 14400
phpro: calls 14400
7SkYy: raises 72250 to 86650 and is all-in
dimasiktuta: folds
ValeraB96: folds
phpro: calls 37716 and is all-in
Uncalled bet (34534) returned to 7SkYy
*** FLOP *** [Jc Kh 9c]
*** TURN *** [Jc Kh 9c] [Qh]
*** RIVER *** [Jc Kh 9c Qh] [8s]
*** SHOW DOWN ***
7SkYy: shows [Ad Jd] (a pair of Jacks)
phpro: shows [Kd Js] (two pair, Kings and Jacks)
phpro collected 129432 from pot
*** SUMMARY ***
Total pot 129432 | Rake 0
Board [Jc Kh 9c Qh 8s]
Seat 2: dimasiktuta (big blind) folded before Flop
Seat 5: ValeraB96 folded before Flop
Seat 6: phpro (button) showed [Kd Js] and won (129432) with two pair, Kings and Jacks
Seat 7: 7SkYy (small blind) showed [Ad Jd] and lost with a pair of Jacks


*********** # 366 **************
PokerStars Hand #257048858882: Tournament #3910307458, $0.98+$0.12 USD Hold'em No Limit - Level XXXI (3600/7200) - 2025/07/22 14:54:37 ET
Table '3910307458 12' 9-max Seat #7 is the button
Seat 2: dimasiktuta (519632 in chips)
Seat 5: ValeraB96 (180402 in chips)
Seat 6: phpro (129432 in chips)
Seat 7: 7SkYy (34534 in chips)
dimasiktuta: posts the ante 900
ValeraB96: posts the ante 900
phpro: posts the ante 900
7SkYy: posts the ante 900
dimasiktuta: posts small blind 3600
ValeraB96: posts big blind 7200
*** HOLE CARDS ***
Dealt to phpro [Ah 3h]
phpro: folds
7SkYy: folds
dimasiktuta: raises 7200 to 14400
ValeraB96: calls 7200
*** FLOP *** [Ts 8s 2s]
dimasiktuta: bets 19440
ValeraB96: calls 19440
*** TURN *** [Ts 8s 2s] [Td]
dimasiktuta: bets 43200
ValeraB96: calls 43200
*** RIVER *** [Ts 8s 2s Td] [Kd]
dimasiktuta: checks
ValeraB96: bets 50458
dimasiktuta: calls 50458
*** SHOW DOWN ***
ValeraB96: shows [3s 7s] (a flush, Ten high)
dimasiktuta: mucks hand
ValeraB96 collected 258596 from pot
*** SUMMARY ***
Total pot 258596 | Rake 0
Board [Ts 8s 2s Td Kd]
Seat 2: dimasiktuta (small blind) mucked [2d 8h]
Seat 5: ValeraB96 (big blind) showed [3s 7s] and won (258596) with a flush, Ten high
Seat 6: phpro folded before Flop (didn't bet)
Seat 7: 7SkYy (button) folded before Flop (didn't bet)


*********** # 367 **************
PokerStars Hand #257048911363: Tournament #3910307458, $0.98+$0.12 USD Hold'em No Limit - Level XXXI (3600/7200) - 2025/07/22 15:00:08 ET
Table '3910307458 12' 9-max Seat #2 is the button
Seat 2: dimasiktuta (391234 in chips)
Seat 5: ValeraB96 (310600 in chips)
Seat 6: phpro (128532 in chips)
Seat 7: 7SkYy (33634 in chips)
dimasiktuta: posts the ante 900
ValeraB96: posts the ante 900
phpro: posts the ante 900
7SkYy: posts the ante 900
ValeraB96: posts small blind 3600
phpro: posts big blind 7200
*** HOLE CARDS ***
Dealt to phpro [4s 7c]
7SkYy: raises 25534 to 32734 and is all-in
dimasiktuta: calls 32734
ValeraB96: calls 29134
phpro: folds
*** FLOP *** [5d 4c Td]
ValeraB96: checks
dimasiktuta: checks
*** TURN *** [5d 4c Td] [5c]
ValeraB96: checks
dimasiktuta: checks
*** RIVER *** [5d 4c Td 5c] [7d]
ValeraB96: checks
dimasiktuta: checks
*** SHOW DOWN ***
ValeraB96: shows [Kd Qc] (a pair of Fives)
7SkYy: shows [7h Ah] (two pair, Sevens and Fives)
dimasiktuta: mucks hand
7SkYy collected 109002 from pot
*** SUMMARY ***
Total pot 109002 | Rake 0
Board [5d 4c Td 5c 7d]
Seat 2: dimasiktuta (button) mucked [8s As]
Seat 5: ValeraB96 (small blind) showed [Kd Qc] and lost with a pair of Fives
Seat 6: phpro (big blind) folded before Flop
Seat 7: 7SkYy showed [7h Ah] and won (109002) with two pair, Sevens and Fives


*********** # 368 **************
PokerStars Hand #257048915821: Tournament #3910307458, $0.98+$0.12 USD Hold'em No Limit - Level XXXI (3600/7200) - 2025/07/22 15:00:36 ET
Table '3910307458 12' 9-max Seat #5 is the button
Seat 2: dimasiktuta (357600 in chips)
Seat 5: ValeraB96 (276966 in chips)
Seat 6: phpro (120432 in chips)
Seat 7: 7SkYy (109002 in chips)
dimasiktuta: posts the ante 900
ValeraB96: posts the ante 900
phpro: posts the ante 900
7SkYy: posts the ante 900
phpro: posts small blind 3600
7SkYy: posts big blind 7200
*** HOLE CARDS ***
Dealt to phpro [7c 6s]
dimasiktuta: folds
ValeraB96: folds
phpro: raises 7200 to 14400
7SkYy: calls 7200
*** FLOP *** [8s 4c 2c]
phpro: checks
7SkYy: bets 10692
phpro: folds
Uncalled bet (10692) returned to 7SkYy
7SkYy collected 32400 from pot
7SkYy: doesn't show hand
*** SUMMARY ***
Total pot 32400 | Rake 0
Board [8s 4c 2c]
Seat 2: dimasiktuta folded before Flop (didn't bet)
Seat 5: ValeraB96 (button) folded before Flop (didn't bet)
Seat 6: phpro (small blind) folded on the Flop
Seat 7: 7SkYy (big blind) collected (32400)


*********** # 369 **************
PokerStars Hand #257048925097: Tournament #3910307458, $0.98+$0.12 USD Hold'em No Limit - Level XXXI (3600/7200) - 2025/07/22 15:01:27 ET
Table '3910307458 12' 9-max Seat #6 is the button
Seat 2: dimasiktuta (356700 in chips)
Seat 5: ValeraB96 (276066 in chips)
Seat 6: phpro (105132 in chips)
Seat 7: 7SkYy (126102 in chips)
dimasiktuta: posts the ante 900
ValeraB96: posts the ante 900
phpro: posts the ante 900
7SkYy: posts the ante 900
7SkYy: posts small blind 3600
dimasiktuta: posts big blind 7200
*** HOLE CARDS ***
Dealt to phpro [5d Kh]
ValeraB96: raises 7200 to 14400
phpro: folds
7SkYy: folds
dimasiktuta: calls 7200
*** FLOP *** [Js Ac 8s]
dimasiktuta: checks
ValeraB96: bets 11520
dimasiktuta: calls 11520
*** TURN *** [Js Ac 8s] [5h]
dimasiktuta: checks
ValeraB96: bets 28800
dimasiktuta: calls 28800
*** RIVER *** [Js Ac 8s 5h] [4d]
dimasiktuta: checks
ValeraB96: bets 48816
dimasiktuta: calls 48816
*** SHOW DOWN ***
ValeraB96: shows [As Tc] (a pair of Aces)
dimasiktuta: mucks hand
ValeraB96 collected 214272 from pot
*** SUMMARY ***
Total pot 214272 | Rake 0
Board [Js Ac 8s 5h 4d]
Seat 2: dimasiktuta (big blind) mucked [Ad 7d]
Seat 5: ValeraB96 showed [As Tc] and won (214272) with a pair of Aces
Seat 6: phpro (button) folded before Flop (didn't bet)
Seat 7: 7SkYy (small blind) folded before Flop


*********** # 370 **************
PokerStars Hand #257048932894: Tournament #3910307458, $0.98+$0.12 USD Hold'em No Limit - Level XXXII (4000/8000) - 2025/07/22 15:02:05 ET
Table '3910307458 12' 9-max Seat #7 is the button
Seat 2: dimasiktuta (252264 in chips)
Seat 5: ValeraB96 (385902 in chips)
Seat 6: phpro (104232 in chips)
Seat 7: 7SkYy (121602 in chips)
dimasiktuta: posts the ante 1000
ValeraB96: posts the ante 1000
phpro: posts the ante 1000
7SkYy: posts the ante 1000
dimasiktuta: posts small blind 4000
ValeraB96: posts big blind 8000
*** HOLE CARDS ***
Dealt to phpro [8c Ac]
phpro: raises 8000 to 16000
7SkYy: folds
dimasiktuta: folds
ValeraB96: calls 8000
*** FLOP *** [8d Tc 8h]
ValeraB96: checks
phpro: checks
*** TURN *** [8d Tc 8h] [Td]
ValeraB96: checks
phpro: bets 20000
ValeraB96: folds
Uncalled bet (20000) returned to phpro
phpro collected 40000 from pot
*** SUMMARY ***
Total pot 40000 | Rake 0
Board [8d Tc 8h Td]
Seat 2: dimasiktuta (small blind) folded before Flop
Seat 5: ValeraB96 (big blind) folded on the Turn
Seat 6: phpro collected (40000)
Seat 7: 7SkYy (button) folded before Flop (didn't bet)


*********** # 371 **************
PokerStars Hand #257048937809: Tournament #3910307458, $0.98+$0.12 USD Hold'em No Limit - Level XXXII (4000/8000) - 2025/07/22 15:02:29 ET
Table '3910307458 12' 9-max Seat #2 is the button
Seat 2: dimasiktuta (247264 in chips)
Seat 5: ValeraB96 (368902 in chips)
Seat 6: phpro (127232 in chips)
Seat 7: 7SkYy (120602 in chips)
dimasiktuta: posts the ante 1000
ValeraB96: posts the ante 1000
phpro: posts the ante 1000
7SkYy: posts the ante 1000
ValeraB96: posts small blind 4000
phpro: posts big blind 8000
*** HOLE CARDS ***
Dealt to phpro [2h 7d]
7SkYy: raises 8000 to 16000
dimasiktuta: calls 16000
ValeraB96: folds
phpro: folds
*** FLOP *** [3d 6c 8s]
7SkYy: checks
dimasiktuta: checks
*** TURN *** [3d 6c 8s] [5d]
7SkYy: checks
dimasiktuta: bets 11520
7SkYy: folds
Uncalled bet (11520) returned to dimasiktuta
dimasiktuta collected 48000 from pot
dimasiktuta: doesn't show hand
*** SUMMARY ***
Total pot 48000 | Rake 0
Board [3d 6c 8s 5d]
Seat 2: dimasiktuta (button) collected (48000)
Seat 5: ValeraB96 (small blind) folded before Flop
Seat 6: phpro (big blind) folded before Flop
Seat 7: 7SkYy folded on the Turn


*********** # 372 **************
PokerStars Hand #257048949250: Tournament #3910307458, $0.98+$0.12 USD Hold'em No Limit - Level XXXII (4000/8000) - 2025/07/22 15:03:22 ET
Table '3910307458 12' 9-max Seat #5 is the button
Seat 2: dimasiktuta (278264 in chips)
Seat 5: ValeraB96 (363902 in chips)
Seat 6: phpro (118232 in chips)
Seat 7: 7SkYy (103602 in chips)
dimasiktuta: posts the ante 1000
ValeraB96: posts the ante 1000
phpro: posts the ante 1000
7SkYy: posts the ante 1000
phpro: posts small blind 4000
7SkYy: posts big blind 8000
*** HOLE CARDS ***
Dealt to phpro [As Qc]
dimasiktuta: folds
ValeraB96: folds
phpro: raises 16000 to 24000
7SkYy: folds
Uncalled bet (16000) returned to phpro
phpro collected 20000 from pot
*** SUMMARY ***
Total pot 20000 | Rake 0
Seat 2: dimasiktuta folded before Flop (didn't bet)
Seat 5: ValeraB96 (button) folded before Flop (didn't bet)
Seat 6: phpro (small blind) collected (20000)
Seat 7: 7SkYy (big blind) folded before Flop


*********** # 373 **************
PokerStars Hand #257048955153: Tournament #3910307458, $0.98+$0.12 USD Hold'em No Limit - Level XXXII (4000/8000) - 2025/07/22 15:03:50 ET
Table '3910307458 12' 9-max Seat #6 is the button
Seat 2: dimasiktuta (277264 in chips)
Seat 5: ValeraB96 (362902 in chips)
Seat 6: phpro (129232 in chips)
Seat 7: 7SkYy (94602 in chips)
dimasiktuta: posts the ante 1000
ValeraB96: posts the ante 1000
phpro: posts the ante 1000
7SkYy: posts the ante 1000
7SkYy: posts small blind 4000
dimasiktuta: posts big blind 8000
*** HOLE CARDS ***
Dealt to phpro [5s Tc]
ValeraB96: folds
phpro: folds
7SkYy: calls 4000
dimasiktuta: checks
*** FLOP *** [Td 2s 3d]
7SkYy: checks
dimasiktuta: bets 8000
7SkYy: calls 8000
*** TURN *** [Td 2s 3d] [7h]
7SkYy: checks
dimasiktuta: checks
*** RIVER *** [Td 2s 3d 7h] [4d]
7SkYy: bets 38800
dimasiktuta: folds
Uncalled bet (38800) returned to 7SkYy
7SkYy collected 36000 from pot
7SkYy: doesn't show hand
*** SUMMARY ***
Total pot 36000 | Rake 0
Board [Td 2s 3d 7h 4d]
Seat 2: dimasiktuta (big blind) folded on the River
Seat 5: ValeraB96 folded before Flop (didn't bet)
Seat 6: phpro (button) folded before Flop (didn't bet)
Seat 7: 7SkYy (small blind) collected (36000)


*********** # 374 **************
PokerStars Hand #257048967500: Tournament #3910307458, $0.98+$0.12 USD Hold'em No Limit - Level XXXII (4000/8000) - 2025/07/22 15:04:47 ET
Table '3910307458 12' 9-max Seat #7 is the button
Seat 2: dimasiktuta (260264 in chips)
Seat 5: ValeraB96 (361902 in chips)
Seat 6: phpro (128232 in chips)
Seat 7: 7SkYy (113602 in chips)
dimasiktuta: posts the ante 1000
ValeraB96: posts the ante 1000
phpro: posts the ante 1000
7SkYy: posts the ante 1000
dimasiktuta: posts small blind 4000
ValeraB96: posts big blind 8000
*** HOLE CARDS ***
Dealt to phpro [Td Jd]
phpro: raises 8000 to 16000
7SkYy: folds
dimasiktuta: raises 243264 to 259264 and is all-in
ValeraB96: folds
phpro: folds
Uncalled bet (243264) returned to dimasiktuta
dimasiktuta collected 44000 from pot
dimasiktuta: doesn't show hand
*** SUMMARY ***
Total pot 44000 | Rake 0
Seat 2: dimasiktuta (small blind) collected (44000)
Seat 5: ValeraB96 (big blind) folded before Flop
Seat 6: phpro folded before Flop
Seat 7: 7SkYy (button) folded before Flop (didn't bet)


*********** # 375 **************
PokerStars Hand #257048972571: Tournament #3910307458, $0.98+$0.12 USD Hold'em No Limit - Level XXXII (4000/8000) - 2025/07/22 15:05:09 ET
Table '3910307458 12' 9-max Seat #2 is the button
Seat 2: dimasiktuta (287264 in chips)
Seat 5: ValeraB96 (352902 in chips)
Seat 6: phpro (111232 in chips)
Seat 7: 7SkYy (112602 in chips)
dimasiktuta: posts the ante 1000
ValeraB96: posts the ante 1000
phpro: posts the ante 1000
7SkYy: posts the ante 1000
ValeraB96: posts small blind 4000
phpro: posts big blind 8000
*** HOLE CARDS ***
Dealt to phpro [4c 2h]
7SkYy: raises 8000 to 16000
dimasiktuta: folds
ValeraB96: folds
phpro: folds
Uncalled bet (8000) returned to 7SkYy
7SkYy collected 24000 from pot
7SkYy: doesn't show hand
*** SUMMARY ***
Total pot 24000 | Rake 0
Seat 2: dimasiktuta (button) folded before Flop (didn't bet)
Seat 5: ValeraB96 (small blind) folded before Flop
Seat 6: phpro (big blind) folded before Flop
Seat 7: 7SkYy collected (24000)


*********** # 376 **************
PokerStars Hand #257048974498: Tournament #3910307458, $0.98+$0.12 USD Hold'em No Limit - Level XXXII (4000/8000) - 2025/07/22 15:05:18 ET
Table '3910307458 12' 9-max Seat #5 is the button
Seat 2: dimasiktuta (286264 in chips)
Seat 5: ValeraB96 (347902 in chips)
Seat 6: phpro (102232 in chips)
Seat 7: 7SkYy (127602 in chips)
dimasiktuta: posts the ante 1000
ValeraB96: posts the ante 1000
phpro: posts the ante 1000
7SkYy: posts the ante 1000
phpro: posts small blind 4000
7SkYy: posts big blind 8000
*** HOLE CARDS ***
Dealt to phpro [2s Th]
dimasiktuta: folds
ValeraB96: raises 8000 to 16000
phpro: folds
7SkYy: folds
Uncalled bet (8000) returned to ValeraB96
ValeraB96 collected 24000 from pot
ValeraB96: doesn't show hand
*** SUMMARY ***
Total pot 24000 | Rake 0
Seat 2: dimasiktuta folded before Flop (didn't bet)
Seat 5: ValeraB96 (button) collected (24000)
Seat 6: phpro (small blind) folded before Flop
Seat 7: 7SkYy (big blind) folded before Flop


*********** # 377 **************
PokerStars Hand #257048979828: Tournament #3910307458, $0.98+$0.12 USD Hold'em No Limit - Level XXXII (4000/8000) - 2025/07/22 15:05:42 ET
Table '3910307458 12' 9-max Seat #6 is the button
Seat 2: dimasiktuta (285264 in chips)
Seat 5: ValeraB96 (362902 in chips)
Seat 6: phpro (97232 in chips)
Seat 7: 7SkYy (118602 in chips)
dimasiktuta: posts the ante 1000
ValeraB96: posts the ante 1000
phpro: posts the ante 1000
7SkYy: posts the ante 1000
7SkYy: posts small blind 4000
dimasiktuta: posts big blind 8000
*** HOLE CARDS ***
Dealt to phpro [4s Jd]
ValeraB96: folds
phpro: folds
7SkYy: calls 4000
dimasiktuta: checks
*** FLOP *** [Kd 2d 7d]
7SkYy: bets 8000
dimasiktuta: folds
Uncalled bet (8000) returned to 7SkYy
7SkYy collected 20000 from pot
7SkYy: doesn't show hand
*** SUMMARY ***
Total pot 20000 | Rake 0
Board [Kd 2d 7d]
Seat 2: dimasiktuta (big blind) folded on the Flop
Seat 5: ValeraB96 folded before Flop (didn't bet)
Seat 6: phpro (button) folded before Flop (didn't bet)
Seat 7: 7SkYy (small blind) collected (20000)


*********** # 378 **************
PokerStars Hand #257048983489: Tournament #3910307458, $0.98+$0.12 USD Hold'em No Limit - Level XXXII (4000/8000) - 2025/07/22 15:05:58 ET
Table '3910307458 12' 9-max Seat #7 is the button
Seat 2: dimasiktuta (276264 in chips)
Seat 5: ValeraB96 (361902 in chips)
Seat 6: phpro (96232 in chips)
Seat 7: 7SkYy (129602 in chips)
dimasiktuta: posts the ante 1000
ValeraB96: posts the ante 1000
phpro: posts the ante 1000
7SkYy: posts the ante 1000
dimasiktuta: posts small blind 4000
ValeraB96: posts big blind 8000
*** HOLE CARDS ***
Dealt to phpro [Kc Qc]
phpro: raises 8000 to 16000
7SkYy: folds
dimasiktuta: folds
ValeraB96: folds
Uncalled bet (8000) returned to phpro
phpro collected 24000 from pot
*** SUMMARY ***
Total pot 24000 | Rake 0
Seat 2: dimasiktuta (small blind) folded before Flop
Seat 5: ValeraB96 (big blind) folded before Flop
Seat 6: phpro collected (24000)
Seat 7: 7SkYy (button) folded before Flop (didn't bet)


*********** # 379 **************
PokerStars Hand #257048985676: Tournament #3910307458, $0.98+$0.12 USD Hold'em No Limit - Level XXXII (4000/8000) - 2025/07/22 15:06:08 ET
Table '3910307458 12' 9-max Seat #2 is the button
Seat 2: dimasiktuta (271264 in chips)
Seat 5: ValeraB96 (352902 in chips)
Seat 6: phpro (111232 in chips)
Seat 7: 7SkYy (128602 in chips)
dimasiktuta: posts the ante 1000
ValeraB96: posts the ante 1000
phpro: posts the ante 1000
7SkYy: posts the ante 1000
ValeraB96: posts small blind 4000
phpro: posts big blind 8000
*** HOLE CARDS ***
Dealt to phpro [5h 9h]
7SkYy: folds
dimasiktuta: raises 8000 to 16000
ValeraB96: folds
phpro: calls 8000
*** FLOP *** [Th 3s 4s]
phpro: checks
dimasiktuta: bets 14000
phpro: folds
Uncalled bet (14000) returned to dimasiktuta
dimasiktuta collected 40000 from pot
dimasiktuta: doesn't show hand
*** SUMMARY ***
Total pot 40000 | Rake 0
Board [Th 3s 4s]
Seat 2: dimasiktuta (button) collected (40000)
Seat 5: ValeraB96 (small blind) folded before Flop
Seat 6: phpro (big blind) folded on the Flop
Seat 7: 7SkYy folded before Flop (didn't bet)


*********** # 380 **************
PokerStars Hand #257048989507: Tournament #3910307458, $0.98+$0.12 USD Hold'em No Limit - Level XXXII (4000/8000) - 2025/07/22 15:06:25 ET
Table '3910307458 12' 9-max Seat #5 is the button
Seat 2: dimasiktuta (294264 in chips)
Seat 5: ValeraB96 (347902 in chips)
Seat 6: phpro (94232 in chips)
Seat 7: 7SkYy (127602 in chips)
dimasiktuta: posts the ante 1000
ValeraB96: posts the ante 1000
phpro: posts the ante 1000
7SkYy: posts the ante 1000
phpro: posts small blind 4000
7SkYy: posts big blind 8000
*** HOLE CARDS ***
Dealt to phpro [8d 8s]
dimasiktuta: folds
ValeraB96: raises 8000 to 16000
phpro: raises 77232 to 93232 and is all-in
7SkYy: folds
ValeraB96: folds
Uncalled bet (77232) returned to phpro
phpro collected 44000 from pot
*** SUMMARY ***
Total pot 44000 | Rake 0
Seat 2: dimasiktuta folded before Flop (didn't bet)
Seat 5: ValeraB96 (button) folded before Flop
Seat 6: phpro (small blind) collected (44000)
Seat 7: 7SkYy (big blind) folded before Flop


*********** # 381 **************
PokerStars Hand #257048992876: Tournament #3910307458, $0.98+$0.12 USD Hold'em No Limit - Level XXXII (4000/8000) - 2025/07/22 15:06:40 ET
Table '3910307458 12' 9-max Seat #6 is the button
Seat 2: dimasiktuta (293264 in chips)
Seat 5: ValeraB96 (330902 in chips)
Seat 6: phpro (121232 in chips)
Seat 7: 7SkYy (118602 in chips)
dimasiktuta: posts the ante 1000
ValeraB96: posts the ante 1000
phpro: posts the ante 1000
7SkYy: posts the ante 1000
7SkYy: posts small blind 4000
dimasiktuta: posts big blind 8000
*** HOLE CARDS ***
Dealt to phpro [4c 4s]
ValeraB96: raises 8000 to 16000
phpro: calls 16000
7SkYy: folds
dimasiktuta: calls 8000
*** FLOP *** [5d 6h Jc]
dimasiktuta: checks
ValeraB96: checks
phpro: checks
*** TURN *** [5d 6h Jc] [5h]
dimasiktuta: checks
ValeraB96: bets 22720
phpro: folds
dimasiktuta: folds
Uncalled bet (22720) returned to ValeraB96
ValeraB96 collected 56000 from pot
ValeraB96: doesn't show hand
*** SUMMARY ***
Total pot 56000 | Rake 0
Board [5d 6h Jc 5h]
Seat 2: dimasiktuta (big blind) folded on the Turn
Seat 5: ValeraB96 collected (56000)
Seat 6: phpro (button) folded on the Turn
Seat 7: 7SkYy (small blind) folded before Flop


*********** # 382 **************
PokerStars Hand #257049002120: Tournament #3910307458, $0.98+$0.12 USD Hold'em No Limit - Level XXXII (4000/8000) - 2025/07/22 15:07:22 ET
Table '3910307458 12' 9-max Seat #7 is the button
Seat 2: dimasiktuta (276264 in chips)
Seat 5: ValeraB96 (369902 in chips)
Seat 6: phpro (104232 in chips)
Seat 7: 7SkYy (113602 in chips)
dimasiktuta: posts the ante 1000
ValeraB96: posts the ante 1000
phpro: posts the ante 1000
7SkYy: posts the ante 1000
dimasiktuta: posts small blind 4000
ValeraB96: posts big blind 8000
*** HOLE CARDS ***
Dealt to phpro [5s 2c]
phpro: folds
7SkYy: folds
dimasiktuta: raises 8000 to 16000
ValeraB96: raises 264000 to 280000
dimasiktuta: folds
Uncalled bet (264000) returned to ValeraB96
ValeraB96 collected 36000 from pot
ValeraB96: doesn't show hand
*** SUMMARY ***
Total pot 36000 | Rake 0
Seat 2: dimasiktuta (small blind) folded before Flop
Seat 5: ValeraB96 (big blind) collected (36000)
Seat 6: phpro folded before Flop (didn't bet)
Seat 7: 7SkYy (button) folded before Flop (didn't bet)


*********** # 383 **************
PokerStars Hand #257049007899: Tournament #3910307458, $0.98+$0.12 USD Hold'em No Limit - Level XXXII (4000/8000) - 2025/07/22 15:07:47 ET
Table '3910307458 12' 9-max Seat #2 is the button
Seat 2: dimasiktuta (259264 in chips)
Seat 5: ValeraB96 (388902 in chips)
Seat 6: phpro (103232 in chips)
Seat 7: 7SkYy (112602 in chips)
dimasiktuta: posts the ante 1000
ValeraB96: posts the ante 1000
phpro: posts the ante 1000
7SkYy: posts the ante 1000
ValeraB96: posts small blind 4000
phpro: posts big blind 8000
*** HOLE CARDS ***
Dealt to phpro [5c 8h]
7SkYy: folds
dimasiktuta: folds
ValeraB96: raises 12000 to 20000
phpro: folds
Uncalled bet (12000) returned to ValeraB96
ValeraB96 collected 20000 from pot
ValeraB96: doesn't show hand
*** SUMMARY ***
Total pot 20000 | Rake 0
Seat 2: dimasiktuta (button) folded before Flop (didn't bet)
Seat 5: ValeraB96 (small blind) collected (20000)
Seat 6: phpro (big blind) folded before Flop
Seat 7: 7SkYy folded before Flop (didn't bet)


*********** # 384 **************
PokerStars Hand #257049011070: Tournament #3910307458, $0.98+$0.12 USD Hold'em No Limit - Level XXXII (4000/8000) - 2025/07/22 15:08:01 ET
Table '3910307458 12' 9-max Seat #5 is the button
Seat 2: dimasiktuta (258264 in chips)
Seat 5: ValeraB96 (399902 in chips)
Seat 6: phpro (94232 in chips)
Seat 7: 7SkYy (111602 in chips)
dimasiktuta: posts the ante 1000
ValeraB96: posts the ante 1000
phpro: posts the ante 1000
7SkYy: posts the ante 1000
phpro: posts small blind 4000
7SkYy: posts big blind 8000
*** HOLE CARDS ***
Dealt to phpro [Ad 2h]
dimasiktuta: folds
ValeraB96: raises 8000 to 16000
phpro: folds
7SkYy: folds
Uncalled bet (8000) returned to ValeraB96
ValeraB96 collected 24000 from pot
ValeraB96: doesn't show hand
*** SUMMARY ***
Total pot 24000 | Rake 0
Seat 2: dimasiktuta folded before Flop (didn't bet)
Seat 5: ValeraB96 (button) collected (24000)
Seat 6: phpro (small blind) folded before Flop
Seat 7: 7SkYy (big blind) folded before Flop


*********** # 385 **************
PokerStars Hand #257049016441: Tournament #3910307458, $0.98+$0.12 USD Hold'em No Limit - Level XXXII (4000/8000) - 2025/07/22 15:08:25 ET
Table '3910307458 12' 9-max Seat #6 is the button
Seat 2: dimasiktuta (257264 in chips)
Seat 5: ValeraB96 (414902 in chips)
Seat 6: phpro (89232 in chips)
Seat 7: 7SkYy (102602 in chips)
dimasiktuta: posts the ante 1000
ValeraB96: posts the ante 1000
phpro: posts the ante 1000
7SkYy: posts the ante 1000
7SkYy: posts small blind 4000
dimasiktuta: posts big blind 8000
*** HOLE CARDS ***
Dealt to phpro [3h 8h]
ValeraB96: raises 8000 to 16000
phpro: folds
7SkYy: folds
dimasiktuta: calls 8000
*** FLOP *** [3s 4h 9d]
dimasiktuta: checks
ValeraB96: bets 12800
dimasiktuta: calls 12800
*** TURN *** [3s 4h 9d] [Tc]
dimasiktuta: checks
ValeraB96: checks
*** RIVER *** [3s 4h 9d Tc] [3d]
dimasiktuta: bets 22960
ValeraB96: calls 22960
*** SHOW DOWN ***
dimasiktuta: shows [Th Js] (two pair, Tens and Threes)
ValeraB96: mucks hand
dimasiktuta collected 111520 from pot
*** SUMMARY ***
Total pot 111520 | Rake 0
Board [3s 4h 9d Tc 3d]
Seat 2: dimasiktuta (big blind) showed [Th Js] and won (111520) with two pair, Tens and Threes
Seat 5: ValeraB96 mucked [Qh Ah]
Seat 6: phpro (button) folded before Flop (didn't bet)
Seat 7: 7SkYy (small blind) folded before Flop


*********** # 386 **************
PokerStars Hand #257049021751: Tournament #3910307458, $0.98+$0.12 USD Hold'em No Limit - Level XXXII (4000/8000) - 2025/07/22 15:08:48 ET
Table '3910307458 12' 9-max Seat #7 is the button
Seat 2: dimasiktuta (316024 in chips)
Seat 5: ValeraB96 (362142 in chips)
Seat 6: phpro (88232 in chips)
Seat 7: 7SkYy (97602 in chips)
dimasiktuta: posts the ante 1000
ValeraB96: posts the ante 1000
phpro: posts the ante 1000
7SkYy: posts the ante 1000
dimasiktuta: posts small blind 4000
ValeraB96: posts big blind 8000
*** HOLE CARDS ***
Dealt to phpro [Ts 7s]
phpro: folds
7SkYy: raises 8000 to 16000
dimasiktuta: folds
ValeraB96: raises 184000 to 200000
7SkYy: folds
Uncalled bet (184000) returned to ValeraB96
ValeraB96 collected 40000 from pot
ValeraB96: doesn't show hand
*** SUMMARY ***
Total pot 40000 | Rake 0
Seat 2: dimasiktuta (small blind) folded before Flop
Seat 5: ValeraB96 (big blind) collected (40000)
Seat 6: phpro folded before Flop (didn't bet)
Seat 7: 7SkYy (button) folded before Flop


*********** # 387 **************
PokerStars Hand #257049027427: Tournament #3910307458, $0.98+$0.12 USD Hold'em No Limit - Level XXXII (4000/8000) - 2025/07/22 15:09:14 ET
Table '3910307458 12' 9-max Seat #2 is the button
Seat 2: dimasiktuta (311024 in chips)
Seat 5: ValeraB96 (385142 in chips)
Seat 6: phpro (87232 in chips)
Seat 7: 7SkYy (80602 in chips)
dimasiktuta: posts the ante 1000
ValeraB96: posts the ante 1000
phpro: posts the ante 1000
7SkYy: posts the ante 1000
ValeraB96: posts small blind 4000
phpro: posts big blind 8000
*** HOLE CARDS ***
Dealt to phpro [5c Jd]
7SkYy: folds
dimasiktuta: raises 8000 to 16000
ValeraB96: folds
phpro: folds
Uncalled bet (8000) returned to dimasiktuta
dimasiktuta collected 24000 from pot
dimasiktuta: doesn't show hand
*** SUMMARY ***
Total pot 24000 | Rake 0
Seat 2: dimasiktuta (button) collected (24000)
Seat 5: ValeraB96 (small blind) folded before Flop
Seat 6: phpro (big blind) folded before Flop
Seat 7: 7SkYy folded before Flop (didn't bet)


*********** # 388 **************
PokerStars Hand #257049030522: Tournament #3910307458, $0.98+$0.12 USD Hold'em No Limit - Level XXXII (4000/8000) - 2025/07/22 15:09:27 ET
Table '3910307458 12' 9-max Seat #5 is the button
Seat 2: dimasiktuta (326024 in chips)
Seat 5: ValeraB96 (380142 in chips)
Seat 6: phpro (78232 in chips)
Seat 7: 7SkYy (79602 in chips)
dimasiktuta: posts the ante 1000
ValeraB96: posts the ante 1000
phpro: posts the ante 1000
7SkYy: posts the ante 1000
phpro: posts small blind 4000
7SkYy: posts big blind 8000
*** HOLE CARDS ***
Dealt to phpro [5d Ad]
dimasiktuta: folds
ValeraB96: raises 8000 to 16000
phpro: raises 61232 to 77232 and is all-in
7SkYy: folds
ValeraB96: folds
Uncalled bet (61232) returned to phpro
phpro collected 44000 from pot
*** SUMMARY ***
Total pot 44000 | Rake 0
Seat 2: dimasiktuta folded before Flop (didn't bet)
Seat 5: ValeraB96 (button) folded before Flop
Seat 6: phpro (small blind) collected (44000)
Seat 7: 7SkYy (big blind) folded before Flop


*********** # 389 **************
PokerStars Hand #257049033270: Tournament #3910307458, $0.98+$0.12 USD Hold'em No Limit - Level XXXII (4000/8000) - 2025/07/22 15:09:40 ET
Table '3910307458 12' 9-max Seat #6 is the button
Seat 2: dimasiktuta (325024 in chips)
Seat 5: ValeraB96 (363142 in chips)
Seat 6: phpro (105232 in chips)
Seat 7: 7SkYy (70602 in chips)
dimasiktuta: posts the ante 1000
ValeraB96: posts the ante 1000
phpro: posts the ante 1000
7SkYy: posts the ante 1000
7SkYy: posts small blind 4000
dimasiktuta: posts big blind 8000
*** HOLE CARDS ***
Dealt to phpro [9h Kh]
ValeraB96: raises 8000 to 16000
phpro: calls 16000
7SkYy: folds
dimasiktuta: folds
*** FLOP *** [Ad 8h Jc]
ValeraB96: bets 12800
phpro: calls 12800
*** TURN *** [Ad 8h Jc] [8s]
ValeraB96: bets 15552
phpro: folds
Uncalled bet (15552) returned to ValeraB96
ValeraB96 collected 73600 from pot
ValeraB96: doesn't show hand
*** SUMMARY ***
Total pot 73600 | Rake 0
Board [Ad 8h Jc 8s]
Seat 2: dimasiktuta (big blind) folded before Flop
Seat 5: ValeraB96 collected (73600)
Seat 6: phpro (button) folded on the Turn
Seat 7: 7SkYy (small blind) folded before Flop


*********** # 390 **************
PokerStars Hand #257049041396: Tournament #3910307458, $0.98+$0.12 USD Hold'em No Limit - Level XXXII (4000/8000) - 2025/07/22 15:10:15 ET
Table '3910307458 12' 9-max Seat #7 is the button
Seat 2: dimasiktuta (316024 in chips)
Seat 5: ValeraB96 (406942 in chips)
Seat 6: phpro (75432 in chips)
Seat 7: 7SkYy (65602 in chips)
dimasiktuta: posts the ante 1000
ValeraB96: posts the ante 1000
phpro: posts the ante 1000
7SkYy: posts the ante 1000
dimasiktuta: posts small blind 4000
ValeraB96: posts big blind 8000
*** HOLE CARDS ***
Dealt to phpro [3c 6d]
phpro: folds
7SkYy: folds
dimasiktuta: raises 8000 to 16000
ValeraB96: calls 8000
*** FLOP *** [9c 7h 4s]
dimasiktuta: checks
ValeraB96: bets 19520
dimasiktuta: folds
Uncalled bet (19520) returned to ValeraB96
ValeraB96 collected 36000 from pot
ValeraB96: doesn't show hand
*** SUMMARY ***
Total pot 36000 | Rake 0
Board [9c 7h 4s]
Seat 2: dimasiktuta (small blind) folded on the Flop
Seat 5: ValeraB96 (big blind) collected (36000)
Seat 6: phpro folded before Flop (didn't bet)
Seat 7: 7SkYy (button) folded before Flop (didn't bet)


*********** # 391 **************
PokerStars Hand #257049046244: Tournament #3910307458, $0.98+$0.12 USD Hold'em No Limit - Level XXXII (4000/8000) - 2025/07/22 15:10:36 ET
Table '3910307458 12' 9-max Seat #2 is the button
Seat 2: dimasiktuta (299024 in chips)
Seat 5: ValeraB96 (425942 in chips)
Seat 6: phpro (74432 in chips)
Seat 7: 7SkYy (64602 in chips)
dimasiktuta: posts the ante 1000
ValeraB96: posts the ante 1000
phpro: posts the ante 1000
7SkYy: posts the ante 1000
ValeraB96: posts small blind 4000
phpro: posts big blind 8000
*** HOLE CARDS ***
Dealt to phpro [5h 7s]
7SkYy: folds
dimasiktuta: raises 8000 to 16000
ValeraB96: folds
phpro: folds
Uncalled bet (8000) returned to dimasiktuta
dimasiktuta collected 24000 from pot
dimasiktuta: doesn't show hand
*** SUMMARY ***
Total pot 24000 | Rake 0
Seat 2: dimasiktuta (button) collected (24000)
Seat 5: ValeraB96 (small blind) folded before Flop
Seat 6: phpro (big blind) folded before Flop
Seat 7: 7SkYy folded before Flop (didn't bet)


*********** # 392 **************
PokerStars Hand #257049049702: Tournament #3910307458, $0.98+$0.12 USD Hold'em No Limit - Level XXXII (4000/8000) - 2025/07/22 15:10:51 ET
Table '3910307458 12' 9-max Seat #5 is the button
Seat 2: dimasiktuta (314024 in chips)
Seat 5: ValeraB96 (420942 in chips)
Seat 6: phpro (65432 in chips)
Seat 7: 7SkYy (63602 in chips)
dimasiktuta: posts the ante 1000
ValeraB96: posts the ante 1000
phpro: posts the ante 1000
7SkYy: posts the ante 1000
phpro: posts small blind 4000
7SkYy: posts big blind 8000
*** HOLE CARDS ***
Dealt to phpro [7c 6c]
dimasiktuta: raises 8000 to 16000
ValeraB96: folds
phpro: folds
7SkYy: folds
Uncalled bet (8000) returned to dimasiktuta
dimasiktuta collected 24000 from pot
dimasiktuta: doesn't show hand
*** SUMMARY ***
Total pot 24000 | Rake 0
Seat 2: dimasiktuta collected (24000)
Seat 5: ValeraB96 (button) folded before Flop (didn't bet)
Seat 6: phpro (small blind) folded before Flop
Seat 7: 7SkYy (big blind) folded before Flop


*********** # 393 **************
PokerStars Hand #257049052183: Tournament #3910307458, $0.98+$0.12 USD Hold'em No Limit - Level XXXII (4000/8000) - 2025/07/22 15:11:02 ET
Table '3910307458 12' 9-max Seat #6 is the button
Seat 2: dimasiktuta (329024 in chips)
Seat 5: ValeraB96 (419942 in chips)
Seat 6: phpro (60432 in chips)
Seat 7: 7SkYy (54602 in chips)
dimasiktuta: posts the ante 1000
ValeraB96: posts the ante 1000
phpro: posts the ante 1000
7SkYy: posts the ante 1000
7SkYy: posts small blind 4000
dimasiktuta: posts big blind 8000
*** HOLE CARDS ***
Dealt to phpro [Tc Jc]
ValeraB96: folds
phpro: raises 8000 to 16000
7SkYy: folds
dimasiktuta: folds
Uncalled bet (8000) returned to phpro
phpro collected 24000 from pot
*** SUMMARY ***
Total pot 24000 | Rake 0
Seat 2: dimasiktuta (big blind) folded before Flop
Seat 5: ValeraB96 folded before Flop (didn't bet)
Seat 6: phpro (button) collected (24000)
Seat 7: 7SkYy (small blind) folded before Flop


*********** # 394 **************
PokerStars Hand #257049054496: Tournament #3910307458, $0.98+$0.12 USD Hold'em No Limit - Level XXXII (4000/8000) - 2025/07/22 15:11:12 ET
Table '3910307458 12' 9-max Seat #7 is the button
Seat 2: dimasiktuta (320024 in chips)
Seat 5: ValeraB96 (418942 in chips)
Seat 6: phpro (75432 in chips)
Seat 7: 7SkYy (49602 in chips)
dimasiktuta: posts the ante 1000
ValeraB96: posts the ante 1000
phpro: posts the ante 1000
7SkYy: posts the ante 1000
dimasiktuta: posts small blind 4000
ValeraB96: posts big blind 8000
*** HOLE CARDS ***
Dealt to phpro [4h 7c]
phpro: folds
7SkYy: folds
dimasiktuta: raises 8000 to 16000
ValeraB96: calls 8000
*** FLOP *** [Kc 2s 7h]
dimasiktuta: bets 8640
ValeraB96: raises 21840 to 30480
dimasiktuta: folds
Uncalled bet (21840) returned to ValeraB96
ValeraB96 collected 53280 from pot
ValeraB96: doesn't show hand
*** SUMMARY ***
Total pot 53280 | Rake 0
Board [Kc 2s 7h]
Seat 2: dimasiktuta (small blind) folded on the Flop
Seat 5: ValeraB96 (big blind) collected (53280)
Seat 6: phpro folded before Flop (didn't bet)
Seat 7: 7SkYy (button) folded before Flop (didn't bet)


*********** # 395 **************
PokerStars Hand #257049060257: Tournament #3910307458, $0.98+$0.12 USD Hold'em No Limit - Level XXXIII (4500/9000) - 2025/07/22 15:11:37 ET
Table '3910307458 12' 9-max Seat #2 is the button
Seat 2: dimasiktuta (294384 in chips)
Seat 5: ValeraB96 (446582 in chips)
Seat 6: phpro (74432 in chips)
Seat 7: 7SkYy (48602 in chips)
dimasiktuta: posts the ante 1125
ValeraB96: posts the ante 1125
phpro: posts the ante 1125
7SkYy: posts the ante 1125
ValeraB96: posts small blind 4500
phpro: posts big blind 9000
*** HOLE CARDS ***
Dealt to phpro [9s Jc]
7SkYy: folds
dimasiktuta: folds
ValeraB96: raises 279000 to 288000
phpro: folds
Uncalled bet (279000) returned to ValeraB96
ValeraB96 collected 22500 from pot
ValeraB96: doesn't show hand
*** SUMMARY ***
Total pot 22500 | Rake 0
Seat 2: dimasiktuta (button) folded before Flop (didn't bet)
Seat 5: ValeraB96 (small blind) collected (22500)
Seat 6: phpro (big blind) folded before Flop
Seat 7: 7SkYy folded before Flop (didn't bet)


*********** # 396 **************
PokerStars Hand #257049062997: Tournament #3910307458, $0.98+$0.12 USD Hold'em No Limit - Level XXXIII (4500/9000) - 2025/07/22 15:11:49 ET
Table '3910307458 12' 9-max Seat #5 is the button
Seat 2: dimasiktuta (293259 in chips)
Seat 5: ValeraB96 (458957 in chips)
Seat 6: phpro (64307 in chips)
Seat 7: 7SkYy (47477 in chips)
dimasiktuta: posts the ante 1125
ValeraB96: posts the ante 1125
phpro: posts the ante 1125
7SkYy: posts the ante 1125
phpro: posts small blind 4500
7SkYy: posts big blind 9000
*** HOLE CARDS ***
Dealt to phpro [7d Ad]
dimasiktuta: folds
ValeraB96: raises 448832 to 457832 and is all-in
phpro: folds
7SkYy: calls 37352 and is all-in
Uncalled bet (411480) returned to ValeraB96
*** FLOP *** [2d 7s As]
*** TURN *** [2d 7s As] [5d]
*** RIVER *** [2d 7s As 5d] [8h]
*** SHOW DOWN ***
7SkYy: shows [9d Kh] (high card Ace)
ValeraB96: shows [Qh Kd] (high card Ace - King+Queen kicker)
ValeraB96 collected 101704 from pot
7SkYy finished the tournament in 4th place and received $18.16.
*** SUMMARY ***
Total pot 101704 | Rake 0
Board [2d 7s As 5d 8h]
Seat 2: dimasiktuta folded before Flop (didn't bet)
Seat 5: ValeraB96 (button) showed [Qh Kd] and won (101704) with high card Ace
Seat 6: phpro (small blind) folded before Flop
Seat 7: 7SkYy (big blind) showed [9d Kh] and lost with high card Ace


*********** # 397 **************
PokerStars Hand #257049067622: Tournament #3910307458, $0.98+$0.12 USD Hold'em No Limit - Level XXXIII (4500/9000) - 2025/07/22 15:12:09 ET
Table '3910307458 12' 9-max Seat #6 is the button
Seat 2: dimasiktuta (292134 in chips)
Seat 5: ValeraB96 (513184 in chips)
Seat 6: phpro (58682 in chips)
dimasiktuta: posts the ante 1125
ValeraB96: posts the ante 1125
phpro: posts the ante 1125
dimasiktuta: posts small blind 4500
ValeraB96: posts big blind 9000
*** HOLE CARDS ***
Dealt to phpro [Kh 3h]
phpro: folds
dimasiktuta: raises 9000 to 18000
ValeraB96: calls 9000
*** FLOP *** [7s 8s 3s]
dimasiktuta: bets 18000
ValeraB96: calls 18000
*** TURN *** [7s 8s 3s] [Qs]
dimasiktuta: checks
ValeraB96: checks
*** RIVER *** [7s 8s 3s Qs] [6d]
dimasiktuta: bets 72000
ValeraB96: folds
Uncalled bet (72000) returned to dimasiktuta
dimasiktuta collected 75375 from pot
dimasiktuta: doesn't show hand
*** SUMMARY ***
Total pot 75375 | Rake 0
Board [7s 8s 3s Qs 6d]
Seat 2: dimasiktuta (small blind) collected (75375)
Seat 5: ValeraB96 (big blind) folded on the River
Seat 6: phpro (button) folded before Flop (didn't bet)


*********** # 398 **************
PokerStars Hand #257049074080: Tournament #3910307458, $0.98+$0.12 USD Hold'em No Limit - Level XXXIII (4500/9000) - 2025/07/22 15:12:37 ET
Table '3910307458 12' 9-max Seat #2 is the button
Seat 2: dimasiktuta (330384 in chips)
Seat 5: ValeraB96 (476059 in chips)
Seat 6: phpro (57557 in chips)
dimasiktuta: posts the ante 1125
ValeraB96: posts the ante 1125
phpro: posts the ante 1125
ValeraB96: posts small blind 4500
phpro: posts big blind 9000
*** HOLE CARDS ***
Dealt to phpro [2s 5s]
dimasiktuta: folds
ValeraB96: raises 189000 to 198000
phpro: folds
Uncalled bet (189000) returned to ValeraB96
ValeraB96 collected 21375 from pot
ValeraB96: doesn't show hand
*** SUMMARY ***
Total pot 21375 | Rake 0
Seat 2: dimasiktuta (button) folded before Flop (didn't bet)
Seat 5: ValeraB96 (small blind) collected (21375)
Seat 6: phpro (big blind) folded before Flop


*********** # 399 **************
PokerStars Hand #257049076327: Tournament #3910307458, $0.98+$0.12 USD Hold'em No Limit - Level XXXIII (4500/9000) - 2025/07/22 15:12:47 ET
Table '3910307458 12' 9-max Seat #5 is the button
Seat 2: dimasiktuta (329259 in chips)
Seat 5: ValeraB96 (487309 in chips)
Seat 6: phpro (47432 in chips)
dimasiktuta: posts the ante 1125
ValeraB96: posts the ante 1125
phpro: posts the ante 1125
phpro: posts small blind 4500
dimasiktuta: posts big blind 9000
*** HOLE CARDS ***
Dealt to phpro [5c 7s]
ValeraB96: raises 9000 to 18000
phpro: folds
dimasiktuta: calls 9000
*** FLOP *** [6h 6c 4h]
dimasiktuta: checks
ValeraB96: checks
*** TURN *** [6h 6c 4h] [8h]
dimasiktuta: bets 10530
ValeraB96: raises 20779 to 31309
dimasiktuta: folds
Uncalled bet (20779) returned to ValeraB96
ValeraB96 collected 64935 from pot
ValeraB96: doesn't show hand
*** SUMMARY ***
Total pot 64935 | Rake 0
Board [6h 6c 4h 8h]
Seat 2: dimasiktuta (big blind) folded on the Turn
Seat 5: ValeraB96 (button) collected (64935)
Seat 6: phpro (small blind) folded before Flop


*********** # 400 **************
PokerStars Hand #257049080666: Tournament #3910307458, $0.98+$0.12 USD Hold'em No Limit - Level XXXIII (4500/9000) - 2025/07/22 15:13:06 ET
Table '3910307458 12' 9-max Seat #6 is the button
Seat 2: dimasiktuta (299604 in chips)
Seat 5: ValeraB96 (522589 in chips)
Seat 6: phpro (41807 in chips)
dimasiktuta: posts the ante 1125
ValeraB96: posts the ante 1125
phpro: posts the ante 1125
dimasiktuta: posts small blind 4500
ValeraB96: posts big blind 9000
*** HOLE CARDS ***
Dealt to phpro [Ts Qh]
phpro: raises 31682 to 40682 and is all-in
dimasiktuta: folds
ValeraB96: calls 31682
*** FLOP *** [7d Jc 4h]
*** TURN *** [7d Jc 4h] [9h]
*** RIVER *** [7d Jc 4h 9h] [Tc]
*** SHOW DOWN ***
ValeraB96: shows [Ah Js] (a pair of Jacks)
phpro: shows [Ts Qh] (a pair of Tens)
ValeraB96 collected 89239 from pot
phpro finished the tournament in 3rd place and received $23.29.
*** SUMMARY ***
Total pot 89239 | Rake 0
Board [7d Jc 4h 9h Tc]
Seat 2: dimasiktuta (small blind) folded before Flop
Seat 5: ValeraB96 (big blind) showed [Ah Js] and won (89239) with a pair of Jacks
Seat 6: phpro (button) showed [Ts Qh] and lost with a pair of Tens
